sentence	prediction
Die Zahl der Asylanträge lässt sich offensichtlich steuern, unsere Nachbarstaaten auf dem Balkan haben genau das getan mit der Grenzschließung.	SUBJ
Nachfolgend findet sich wieder aus Israel ein interessanter Vergleich zu dieser Fragestellung:      Vergleich Hospizrate von Geimpften mit Ungeimpften nach Hospiz / 100.000 Personen.	OBJ
Wie wenden wir Chili zur Krebsvorsorge an?	OBJ
„Der Nutzen im Verhältnis zum Schaden ist gut vertretbar.“	OBJ
Ein Grund dafür ist, dass innere Autopsien bei als ansteckend betrachteten Toten vermieden werden sollen.	OBJ
Testergebnisse hängen von der Häufigkeit der Krankheit ab	OBJ
Hintergrund: Die Wahl des geeigneten Studientyps ist ein wichtiger Aspekt des Designs medizinischer Studien.	OBJ
Zu diesem Ergebnis kommt auch der „Cashkurs“-Beitrag:„Nicht nur in den USA und auf dem afrikanischen Kontinent, sondern auch in vielen Teilen des Rests der Welt scheint das Vertrauen in einen mit Pauken und Trompeten durch Politik, Forschung und Pharmafirmen durchgepeitschten Impfstoff gegen das neue Coronavirus ziemlich gering zu sein.“	OBJ
Wir bearbeiten im BfV weiterhin eine Vielzahl von Gefährdungssachverhalten.	OBJ
„Dekadenz – Jubelnd in den Untergang“, heißt das Werk des Filmemachers Imad Karim – eine schonungslose Abrechnung, die jeder kritische Geist gesehen haben sollte.	SUBJ
Auch hier muss der Staat für etwaige Impfschäden aufkommen.	OBJ
Die schlechten hygienischen Zustände, in denen die Testkits aber auch die Masken erzeugt und verpackt werden, fallen auch bei den Endnutzern auf.	OBJ
Doch zeigt er Rückgrat: „Es liegt jedoch nicht in meiner Natur, zuzulassen, dass wissenschaftliche Fakten vor der Öffentlichkeit verborgen werden.“ 	SUBJ
In jedem Gerichtsverfahren gegenüber Behörden, jedem Arbeitgeber, jedem Reiseanbieter, jedem Heimleiter usw. kann man sich nun darauf berufen.	OBJ
Der Sprecherin des RKI zufolge können Verstorbene, die zu Lebzeiten nicht auf COVID-19 getestet worden waren, aber in Verdacht stehen, an COVID-19 gestorben zu sein, post mortem - also nach ihrem Tod - auf das Virus untersucht werden.	OBJ
„Wir haben einen großen Fehler gemacht und haben das bis jetzt nicht erkannt“, bekannte kürzlich der kanadische Impfstoff-Forscher Byram Bridle im Interview mit der kanadischen Journalistin Alex Pierson.	OBJ
Dass der Bayerische Rundfunk als Anstalt der ARD hiermit eine rote Linie überschreitet, die mit seriösem Journalismus nicht mehr vereinbar ist, und viele Moderatoren, Redakteure und Redakteurinnen diesen Weg mitgehen, erinnert an dunkle Zeiten und ist im Nachkriegsdeutschland eine noch nie da gewesene Abkehr von Standards einer für eine Demokratie wichtigen freien Berichterstattung, freien Presse, allemal im Rundfunkstaatsvertrag verankerten Verpflichtung der öffentlich-rechtlichen Anstalten.	SUBJ
Kein Wunder also, dass dieser Trick ebenfalls nicht bei den NPI funktioniert.	SUBJ
Er beantwortete mir alle Fragen und befreite mich von Zweifeln.	SUBJ
Es wird hier auch wieder nur sehr kurz auf den Einzelfall einer älteren Seniorin eingegangen:    Ein Fall betraf eine 80 Jahre alte Frau mit bekannter Faktor-V-Leiden-Mutation und schwerwiegenden thromboembolischen Ereignissen in der Vorgeschichte.	OBJ
Meines Erachtens nach, lehnten nur fünf Artikel die AGW ab: Avakyan (2013a, 2013b), Gervais (2014), Happer (2014) und Hug (2013).	OBJ
Nun zum Wochenbericht in möglichst kurzen Worten:  COVID-Sterblichkeit und COVID-Intensivbelegung passen nicht zusammen.	SUBJ
Als letztes Glied in der Fälschungskette verdienen auch die Bestatter mit.	SUBJ
Wie das PEI mit dieser Quelle auf 13,9 kommt ist uns schlichtweg ein Rätsel.	SUBJ
In fünf Fällen wurden Herzmuskelentzündungen (Myokarditiden) diagnostiziert.	OBJ
Trumps Berater Jason Miller bestritt auf Twitter die Richtigkeit des Arizona-Ergebnisses.	OBJ
Diese Impfstoffe können weder vor einer Virusinfektion schützen, noch konnte bis dato irgendein positiver Effekt nachgewiesen werden.	OBJ
"""Leider ist die Lage nicht einfach"", sagte Präsident Wladimir Putin am Mittwoch bei einer Videokonferenz mit der Regierung."	OBJ
Aktuell sind noch 14 Bewohner und ein Mitarbeiter erkrankt.	OBJ
Wenn der Lockdown wenigstens keinen Schaden anrichtete, könnte wir damit ja noch leben.	SUBJ
Die Einrichtungen sind in der Verantwortung, eine umfassende Umsetzung der Testanordnung sicherzustellen.	OBJ
Sobald die Wahlzeit (§ 47) abgelaufen ist, wird dies vom Wahlvorsteher bekanntgegeben.	OBJ
"Jan Muntendorf, Sprecher der Schutzgemeinschaft Deutscher Wald (SDW) in Hamburg, sagte der WELT: ""Ich bin entsetzt."	OBJ
Als sich darüber Berichte mehrten, verschwand plötzlich vor Ostern am 1. April Israel komplett aus den Daten, nur um am 8. April mit stark nach unten revidierten Zahlen wieder aufzutauchen.	OBJ
Es war erwartet worden, dass Erdogan den russischen Präsidenten Wladimir Putin trifft, nachdem vergangene Woche 33 türkische Soldaten von der syrischen Luftwaffe in Idlib getötet worden waren.	OBJ
Herdenimmunität bedeute selbst im besten Fall nicht, dass niemand erkranken könne.	OBJ
Wenn wir uns nicht gegen Impfpässe wehren und stattdessen „für die Vernunft stimmen“, könnten die Medikamenten- und Impfstoffhersteller die Welt in eine langfristige wirtschaftliche und politische Abhängigkeit zwingen.	SUBJ
Kritiker eines solchen Ansatzes, die geltend machen, dass dieses Thema im Kindergarten nichts zu suchen habe, gelten dagegen laut der” Gesellschaft für Sexualpädagogik” als christlich-fundamentalistisch oder rechtspopulistisch.	OBJ
Damals konnte er seine Meinung im öffentlich-rechtlichen Rundfunk persönlich vertreten, seit Corona geht das nicht mehr.	SUBJ
So ist auch für das laufende Jahr nicht damit zu rechnen, dass Selbstmorde die Übersterblichkeit begründen können.	OBJ
Dies würde bedeuten, dass wir es im ersten Jahr mit bis zu über 22 Millionen Nebenwirkungen und bis zu möglichen 240.000 Todesfällen im zeitlichen Zusammenhang mit der Covid-19-Impfung zu tun hätten.	OBJ
Entscheidet sich der Gesetzgeber für die Sanktion der vorübergehenden Minderung existenzsichernder Leistungen, fehlen der bedürftigen Person allerdings Mittel, die sie benötigt, um die Bedarfe zu decken, die ihr eine menschenwürdige Existenz ermöglichen.	OBJ
Es kann entweder bewirken, dass die Blutplättchen verklumpen und das kann zu Blutgerinnseln führen.	OBJ
Nur sechs Prozent der zu erwartenden Probleme würden gemeldet.	OBJ
Dennoch versucht er zuversichtlich zu bleiben und hofft, dass bald alles wieder gut sein wird.	OBJ
Daniel Weinmann arbeitete viele Jahre als Redakteur bei einem der bekanntesten deutschen Medien.	OBJ
Eine Vorabstudie des Klinikums Hochrhein in Waldshut-Tiengen belegt: Im Frühjahr gab es eine Übersterblichkeit, doch nur etwa die Hälfte der Todesfälle hatte einen Bezug zu COVID-19.	OBJ
Wie aus einer Antwort des Bundesfinanzministeriums auf eine Anfrage des Linken-Fraktionsvorsitzenden Dietmar Bartsch hervorgeht, werden in diesem Jahr voraussichtlich 4,4 Millionen Personen den Spitzensteuersatz zahlen, der ursprünglich nur für absolute Spitzenverdiener gedacht war.	OBJ
Weiterhin führt Renz in der Diskussion aus, dass ein Fünfjahresdurchschnitt der Daten, denen Beschwerden oder mögliche unerwünschte Nebenwirkungen von Impfstoffen zugeschrieben werden, aus den Jahren 2016 bis 2020 ermittelt wurde.	OBJ
Liposome sind zwar nanoskalig, gehören aber rechtlich nicht zu den Nanomaterialien, da sie nicht gezielt so winzig klein hergestellt werden und obendrein nicht stabil genug sind.	OBJ
"Das ""Institut für das Entgeltsystem im Krankenhaus"" liefert ganz andere Zahlen zu den auf Intensivstationen behandelten COVID-19-Fallzahlen als das DIVI-Register."	OBJ
In Zeiten einer besonders hohen Übersterblichkeit, in den Kalenderwochen 14 und 15 und seit Kalenderwoche 49, lag die Übersterblichkeit allerdings über der Zahl der übermittelten COVID-19-Sterbefälle (eGrafik 4).	OBJ
Ich schicke heute noch mal einen mit.	SUBJ
Sie kippte Essig und Chlorreiniger zusammen und atmete das entstehende Chlorgas ein.	OBJ
Die Beobachtungen in den Punkten 1-3 lassen den Schluss zu, dass der effektive R0-Wert schon nach den ersten 30 Tagen nach Beginn der „Pandemie“ weltweit um die „1“ oszillierte.	OBJ
Regelmäßig Händewaschen und sich nicht ins Gesicht greifen, sind demnach natürlich weiter wichtige Maßnahmen, um eine Ansteckung zu vermeiden.	OBJ
Als Grenzwert soll künftig eine Inzidenz von 100 Coronafällen pro 100.000 Einwohnern dienen.	OBJ
Versuche haben gezeigt, dass sich der Abrieb der Mikroplastikfasern aus dem Maskenflies mit der Zeit deutlich erhöht.	OBJ
Und über die richtige Anwendung werden die Bürger auch gar nicht erst informiert.	SUBJ
Zusammen mit Restchina und weltweit sind wir möglicherweise bei rund 60.000 Infektionen.	OBJ
Dass das Spike-Protein des Coronavirus etwas Besonderes ist, weiß man schon länger.	SUBJ
"""Wenn wir wissen, dass wir mit spätestens Mitte, Ende Juni so viele Impfdosen in Österreich haben werden, dass wir Leute suchen werden müssen, die sich impfen lassen"", dann sei jede zusätzliche Möglichkeit gut."	OBJ
Er war Geschäftsführer in gemeinnützigen, öffentlichen und privaten Krankenanstalten, Ordensspitälern sowie Alten- und Pflegeheimen und Rehabilitationskliniken in mehreren Bundesländern.	OBJ
Hintergrund: Die SARS-CoV-2-Pandemie hat im Jahr 2020 das Gesundheitswesen vor große Herausforderungen gestellt.	OBJ
Wie es um die moralische Integrität eines notorischen Lügners bestellt ist, muss man nicht mehr diskutieren [Bidens beste Lügen finden sich hier]	SUBJ
Im roten Kreis sehen wir das Jahr 2021, das fast durchgängig eine Übersterblichkeit bei den 15- bis 44-Jährigen ausweist.	OBJ
Die Regierung hat deshalb einen Gesetzentwurf (19/21750) vorgelegt, der auch auf den EU-Austritt Großbritanniens eingeht.	OBJ
“Denn während die Immunisierten Teilhabe am öffentlichen Leben erhalten, wird sie den Nichtimmunisierten verwehrt.	OBJ
Nächster Schritt: Ab Spätsommer soll eine Impfpflicht als Voraussetzung für den Schulbesuch kommen.	OBJ
Dabei gehe es um die Anpassung und Erweiterung der bestehenden Zulassung auf diese Altersgruppe, teilten die Unternehmen mit.	OBJ
Das Mädchen rannte auf direktem Weg nach Hause.	OBJ
In einer aktuellen britischen Studie zeigte sich, dass 30,3 Prozent der Kinder und Jugendlichen mit einem positiven PCR-Test drei Monate nach der Infektion unter mindestens drei Krankheitssymptomen litten.	OBJ
Jetzt weiß ich, warum Friedrich Merz die ganze Zeit gut gelaunt ist.	SUBJ
Insgesamt müsste dann folgende Anzahl an Menschen eine Impfnebenwirkung erwarten:Das entspricht allen Einwohnern einer Stadt wie Aachen, Mainz oder Kiel!	OBJ
Auf der Netzseite der Unfallversicherung finden sich lange Anleitungen der Berufsgenossenschaften zum Arbeitsschutz beim Umgang mit solchen Fasern und Links zur Bundesanstalt für Arbeitsschutz und Arbeitsmedizin, die die verschiedenen TRGS, die technischen Regeln zum Umgang mit Gefahrstoffen, auflisten.	OBJ
Im Zusammenhang mit dem Ausbruch von SARS – verursacht durch ein Coronavirus namens SARS-CoV – untersuchte das NIH Chloroquin und kam zu dem Schluss, dass es das SARS-Coronavirus wirksam in Schach halten kann.	OBJ
Da das CDC die Korrektur in aller Stille vollzogen hat und die Medien darüber schweigen, ist nicht davon auszugehen, dass man hier eine Botschaft laut verkünden will.	SUBJ
Auf Basis dieses Tests werden Maßnahmen verhängt und Lockdowns beschlossen.	OBJ
Eine Klage, die letzte Woche vor dem Gericht in Den Haag eingereicht wurde, in der die israelische Regierung beschuldigt wird, den Nürnberger Kodex zu verletzen, indem sie durch Pfizer illegale Experimente an Bürgern durchführt, wurde bestätigt.	OBJ
Die üblichen Nazi-oder Leugner-Stempel einfach ignorieren.	SUBJ
Das, was wir bisher aus ärztlicher Erfahrung als Verhaltensregel, sozusagen als Lebensweisheit gegeben haben, dann in einen Risikoalgorithmus umzusetzen, war eine große Leistung.	SUBJ
Zudem haben die Forscher des Hamburger Umweltinstituts flüchtige organische Kohlenwasserstoffe in den Masken, die überwiegend aus China stammen, gefunden.	OBJ
In Deutschland geben Krankenhausabrechnungen Anhaltspunkte für einen enormen Anstieg der Nebenwirkungen.	OBJ
Hat man jemals etwas von einem verbalen Angriff der Identitären auf Japaner, Chinesen oder Vietnamesen gehört?	SUBJ
Wie sieht die Risiko-Nutzen-Analyse aus?	OBJ
Anamnestisch waren Vorerkrankungen darunter eine traumatische Subarachnoidalblutung bekannt.	OBJ
Die Weiterfahrt wird durch Eismassen blockiert, die es nach fester Überzeugung der Gruppe im Sommer eigentlich nicht mehr geben dürfte.	OBJ
Seit 2020 steht „Corona“ im Totenschein.	SUBJ
In Grossbritannien starben von knapp zehn Millionen Geimpften kurze Zeit später nicht weniger als 244 Menschen, einschliesslich acht Fehlgeburten (Stand Ende Januar).	OBJ
Das Gesundheitsministerium in Tokio untersucht derzeit den Zusammenhang zwischen dem Tod zweier Männer und verunreinigten Moderna-Ampullen.	OBJ
Denn die Infektion ist Voraussetzung der Infektiosität.	SUBJ
Die massiven Nebenwirkungen und Langzeitfolgen der Impfkampagnen mit den gentechnischen Medikamenten, geleugnet von Politik und Pharmaindustrie, werden immer offensichtlicher.	SUBJ
Die dortigen Fälle hätten „keine große Relevanz“, weil schnell durchgegriffen werde.	OBJ
Ob ein Virus vermehrungsfähig ist und damit ein Krankheitserreger im Sinne des IfSG ist oder nicht, wird durch die PCR-Tests jedoch nicht festgestellt.	OBJ
Das ist mehr als ich mit meiner eigentlichen Arbeit in einer WOCHE verdiene!	SUBJ
Das habe er nun von seiner undurchdachten Scherzerei, soll ihm seine Frau daraufhin vorgeworfen haben, schildert der 39-Jährige in einem seiner neuesten Videos.	OBJ
Eine heikle Aufgabe, aufschieben sollte man sie nicht.	SUBJ
Ferner hat der Staat die Möglichkeit, bei bargeldlosem Zahlungsverkehr jeden einzelnen ihm unangenehmen Menschen per einfachem Mausklick finanziell von allen Zahlungen abzuschneiden und ihn damit quasi in den Tod zu treiben.	SUBJ
Und hier ist dann die Botschaft, man kann natürlich mehr machen, und das entspricht jetzt vielleicht auch so in grober Näherung dem, was wir hier schon in Deutschland auch jetzt machen.	SUBJ
Und das obwohl in den Statistiken des PEI „im Rahmen der Spontanerfassung nicht alle Fälle berichtet werden (Dunkelzifferrate)“.	OBJ
Lediglich 2021, als die Impfkampagne begann, stiegen die Zahlen enorm an, erklärt Renz in der Diskussion.	OBJ
Da ab November 2020 nur Intensivabteilungen hohe Covid-Zulagen bekamen, die eine 75-prozentige Auslastung gemeldet haben, wurden freie Betten einfach nicht gemeldet, wenn es notwendig war, die 75 Prozent darzustellen.	OBJ
Bei Covid-19-Impfstoffen werden in Phase II oft zwei unterschiedliche Dosierungen getestet.	OBJ
Den Gesetzentwurf zur Reform des Stiftungsrechts und den stiftungsrechtlichen Teil des Änderungsantrags begrüße man grundsätzlich, müsse ihn aber auf Grund der dargelegten Argumente in der Gänze ablehnen.	OBJ
Wo zuvor Todkranke gemeldet wurden, sind nun plötzlich milde Fälle und Menschen, die eigentlich kerngesund sind, in der Meldestatistik enthalten.	OBJ
Bei den schweren Nebenwirkungen waren traten bis zum 31.12.2020 insgesamt 11.310 Fälle auf – bei den Corona Impfungen 2.003 Fälle.	OBJ
Im vergangenen Jahr war die Zahl noch auf 4,2 Millionen geschätzt worden, 2015 erreichten nur etwa 3,5 Millionen Personen mit ihren Einkünften den Spitzensteuersatz.	OBJ
Mund­at­mung führt zudem zu deut­lich mehr Neben­wir­kungen als reinen Zahn­in­fek­tionen.	OBJ
Ebenfalls wissen Politiker, Wissenschaftler, Journalisten und die Interessenten der Windindustrie, dass die Abschöpfung von Windenergie in Zusammenhang mit der immer stärker ausgeprägten Windberuhigung steht.	OBJ
Nach der Impfung könnte es zu spät sein.	OBJ
Bei Intensivpatienten liegt er bei 15,7 bzw. 44,5 Prozent.	OBJ
Studien belegen, dass die Elite ihre Kinder nicht impft.	SUBJ
Damit die Familien denken, dass sie gestorben sind.	SUBJ
2015 stellte das US-Landwirtschaftsministerium fest, dass 94% des nationalen Baumwollanbaus aus genetisch modifizierten Sorten besteht, die entsprechende Herbizid- und Insektenresistenzen aufweisen.	OBJ
Einen vorläufigen Tiefpunkt lieferte der Rundschau-Journalist Thomas Vogel, der seinen Beitrag «Ärzte im Visier: Behörden gegen Corona-Skeptiker» vom 10. Februar mit dem Aufruf abschliesst: «Der Staat muss entscheiden, wieviel Freiheit er den corona-skeptischen Ärzten zugestehen soll.	OBJ
Wenn man die Corona-Toten weltweit nimmt und durch die Weltbevölkerung von 7,827 Milliarden dividiert, dann ist das ein Anteil von 0,0001 die gestorben sind.	OBJ
Oder: Mit welcher Klimaänderung müssen wir rechnen, wenn große Teile des tropischen Regenwaldes vernichtet werden?	SUBJ
Sogar das RKI gibt auf seiner Webseite an, dass beim bestimmungsgemäßen Einsatz von FFP2-Masken eine arbeitsmedizinische Vorsorgeuntersuchung im Voraus angeboten werden muss.	OBJ
Zu der Kundgebung wurden 10.000 Teilnehmer und rund 5000 Traktoren erwartet.	OBJ
Der Kopp Verlag beschreibt den Inhalt des Videos mit den prägnanten Worten: „Es ist zu erwarten, dass solche selbstzerstörerischen Prozesse Myriaden von Nebenwirkungen bei allen Geimpften, insbesondere nach Booster-Impfungen, haben werden.	OBJ
Weiter merkt er an, dass man bei der kommenden Wahl entscheiden muss, ob man seinen neuen Weg weiter führen will.	OBJ
Immer ging es um die Impfung als allein seligmachende Lösung.	SUBJ
Die Zeit der Worte muß nun der Vergangenheit angehören.	SUBJ
Es wäre also wichtig, dass Personen, die mit MNB ausgestattet arbeiten müssen, entsprechend geschult würden, und regelmäßig MNB- freie Intervalle, in denen sie ohne dieselbe atmen können, zugestanden werden.	OBJ
In der psychiatrischen Lüneburger Klinik „Am Wienebütteler Weg“ ist am Freitag gegen 2:10 Uhr zunächst ein 54-jähriger Patient niedergemetzelt worden.	OBJ
Sie hat sich im Vorjahr etwa auch für eine Pflichtimpfung gegen Masern ausgesprochen.	OBJ
Jetzt wäre es an der Zeit, dass die Amerikaner und die anderen nachziehen.	SUBJ
Neben dem Rettungsdienst und der Polizei kam ebenso die DEKRA im Rahmen der Verkehrsunfallaufnahme vor Ort.	OBJ
Manche Kliniken bauten dabei erstaunliche Kapazitäten auf.	SUBJ
Tineye sagt, dies sei ein einzigartiges Bild und tauche nirgendwo im Internet auf.	OBJ
Sie kommen mit mehrmonatiger Verspätung.	OBJ
Man male ledig­lich das Schreck­ge­spenst der Muta­tionen an die Wand, um weiterhin die Bevöl­ke­rung in Panik zu versetzen und sie Entrechten zu können.	SUBJ
Nicht nur betreffen derartige Einschränkungen damit „faktisch fast ganz Deutschland„, wie es aus den Ländern heißt.	SUBJ
Dieser Wert wird von 1 abgezogen und mit hundert multipliziert, so dass man es bequem in Prozenten ausdrücken kann.	OBJ
Allein bezogen auf Hospitalisierte liegt der Anteil bei „Impfdurchbrüchen“ entsprechend bei 29 bzw. bei 54,5 Prozent.	OBJ
Ein Preisaushang reiche dafür nicht aus.	OBJ
Bleibe informiert und folge uns auf Telegram – Corona ist nicht das Problem	SUBJ
Da selten die Informationen vollständig und nachvollziehbar gegeben werden, müssen wir wach bleiben und nachfragen.	SUBJ
Russische Medien berichteten auf dem Höhepunkt der Epidemie, dass ein persönliches Treffen mit Putin nur nach einer zweiwöchigen Quarantäne möglich sei.	OBJ
Dies hätten Untersuchungen aus Spanien ergeben.	OBJ
Trumps Sohn Eric habe versucht, die Auszählung im ebenfalls wichtigen Pennsylvania anzuzweifeln.	OBJ
Eine ARE ist bei GrippeWeb definiert als eine neu aufgetretene Atemwegserkrankung mit Husten ODER Halsschmerzen ODER Fieber (unabhängig von einem etwaigen Erregernachweis).	OBJ
Eine mit uns bekannte junge Sanitäterin, Rosemarie Hörnig, hatte in jener Nacht mit ihrer Mutter Dienst am Hauptbahnhof.	OBJ
Die durch Impfungen erzeugten Antikörper nehmen nach einigen Monaten deutlich ab.	OBJ
Darauf haben sich ÖVP und Grüne geeinigt.	OBJ
Es ist eine Tatsache, dass Deutschland seit Jahren einen strukturellen Exportüberschuss und den größten Niedriglohnsektor in Westeuropa hat.	OBJ
70,6% der Befragten gaben an, „immer“ eine Maske zu tragen, weitere 14,4% erklärten, „häufig“ eine Maske zu tragen.	OBJ
SPIEGEL: Würden Sie Ihre Vorschläge eigentlich als grün bezeichnen?	SUBJ
Sie weigerte sich in Interviews standhaft, die Frage zu beantworten, ob sie dafür sei, Frauen und Kinder aus Griechenland zu holen.	OBJ
Die Werbung ist nicht zu übersehen, es ist ja auch ein US-Amerikanisches Produkt.	SUBJ
Vielmehr war Schwab darüber hinaus der Meinung, dass der Kapitalismus an sich grüner, nachhaltiger und sozialer werden müsse, um einen globalen wirtschaftlichen Aufschwung zu ermöglichen.	SUBJ
Gesamtantikörperprävalenzen unter 80% wiesen die Blutspenderegionen Dresden, Erfurt, Bayern Süd-Ost, Berlin, Görlitz und Leipzig auf.	OBJ
Viele davon durchaus schwer und mit Symptomen, die zumindest keinen Unterschied zu einer normalen Corona-Infektion erkennen lassen.	SUBJ
Für FFP2-N95-Masken lag der durchschnittlicher CO2 -Wert mit 11.000 ppm (Bereich 7000 – 15.000) bei 349 Prozent des Normalwerts.	OBJ
Sie wissen, wer wen treffe, sie sehen nicht nur, welche Symptome eine Person hat, sondern auch welche Wertesystemen oder politischen Einstellungen – und damit, ob er eine Gefahr für das System werden könne.	SUBJ
In Norwegen sind bisher 23 Menschen nach der Verabreichung der ersten Teilimpfung mit dem Serum von Biontech/Pfizer verstorben.	OBJ
Für die Koalition, die nur wenige Monate vor der Bundestagswahl steht, ist das Ergebnis ein wichtiger Weckruf.	SUBJ
Einfache Hygie­ne­maß­nahmen, wie Hände­wa­schen und im Krank­heits­fall zu Hause bleiben, sollten von allen prak­ti­ziert werden, um die Herdenim­mu­ni­täts­schwelle zu senken.	OBJ
Er fügte seine Besorgnis darüber hinzu, warum die Entdeckung von Graphenoxid in den Impfstoffen nicht breiter von den Mainstream-Medien berichtet wird.	OBJ
Aber das scheint die Impffanatiker nicht in ihrem Wahn zu bremsen.	SUBJ
Alternative Medienplattformen florieren zuallererst, weil die Etablierten ihren Aufgaben als demokratisches Korrektiv nicht mehr nachkommen.	SUBJ
Ist es daher für Frauen wirklich sinnvoll, eine heterosexuelle Lebensweise zu führen und so das Risiko von Geschlechtskrankheiten  und Schwangerschaft einzugehen?	SUBJ
Die Zahlen sind also vergleichbar und werden auch von den Betreibern, der US-Seuchenschutzbehörde CDC und der Arzneimittelbehörde FDA, genutzt.	OBJ
Anmerkung: Wenn du dir nicht vorstellen kannst, dass dir die Regierung gegen deinen Willen und ohne dein Einverständnis toxische Substanzen verabreichen würde, solltest du dich an all die schrecklichen Menschenversuche erinnern, die im Nachhinein zugegeben wurden und gemäss Wikipedia bis weit in die Moderne reichten.	SUBJ
Das reicht aber nicht aus, um eine COVID-Erkrankung auszulösen.	SUBJ
In Anbetracht der Übervölkerung stellt sich folgende Frage: Wie könnte die Menschheit überleben, wenn alle heterosexuell wären?	SUBJ
Dana Samson studiert an einer deutschen Universität und schreibt hier unter Pseudonym.	OBJ
„Was von der wissenschaftlichen Gemeinschaft entdeckt wurde, ist, dass das Spike-Protein allein fast vollständig für die Schäden am Herz-Kreislauf-System verantwortlich ist, wenn es in den Blutkreislauf gelangt.“	OBJ
Dies verwundert Experten wenig, denn mit den Impfungen wurden gegen alle Prinzipien der Medizin bzw. Virologie verstoßen, die bislang galten: Niemals während einer Pandemie impfen, denn das generiert Fluchtmutationen.	SUBJ
Doch seinen Fans fiel auf: „Warum hängt seine rechte Körperseite so schlaff nach unten?“.	SUBJ
Das ergibt eine Reuters-Zählung auf Basis offizieller Daten.	OBJ
Doch die Zahlen müssen alle Dimensionen sprengen.	SUBJ
Dies beruhe auf einer voreingenommen Ausblendung von Variablen.	OBJ
Insgesamt betrafen die Verdachtsmeldungen nach wie vor vor allem Frauen.	OBJ
In den USA erlitten zahlreiche Patienten „mysteriöse Blutgerinnungskomplikationen“ durch das Corona-Virus.	OBJ
Im Klartext bedeutet die Aussage des Sprechers: Die PCR-Tests sind so gut wie fehlerfrei.	OBJ
Als außerordentlicher Professor für Virusimmunologie an der University of Guelph ist Bridle kein Außenstehender, der die Sache beobachtet: Er erhielt einen staatlichen Zuschuss in Höhe von 230’000 Dollar für die Forschung zur Entwicklung eines COVID-Impfstoffs.	OBJ
Das RKI hat sich zum Büttel der Politik gemacht.	SUBJ
Die Richtlinien sind für alle Ärzte, Kliniken und medizinisches Fachpersonal gedacht und somit für alle, die PCR-Tests durchführen und auswerten.	OBJ
d. Red: In einer ersten Fassung hieß es, bei den neuen Fällen handele es sich um den Wildtyp des Virus.	OBJ
Auch beim Kopp-Verlag versandkostenfrei erhältlich.	OBJ
Das Israel Ministry of Health hat für den Zeitraum vom 27. Juni bis 3 Juli auf die fast gesamten Daten der israelischen Bevölkerung zugegriffen und Geimpfte mit Ungeimpften verglichen.	OBJ
Beispiel: Wir haben zwei Autounfälle.	OBJ
Statt unabhängig mit einer solchen Studie das wirkliche Infektionsgeschehen und die Wirksamkeit von Gegenmaßnahmen zu untersuchen, empfahl man, politisch gewollt, unsinnige Massentests und breiteste Streuung von zweifelhaften „Schutzmaßnahmen“.	SUBJ
Mit einem Rekordhaushalt von 17,6 Milliarden Euro blieben Bildung und Forschung Priorität der Bundesregierung.	OBJ
Die örtlichen Friedhöfe liegen weitgehend friedlich und verlassen unter dem ersten Schnee dieses Winters.	OBJ
Gastbeiträge geben immer die Meinung des Autors wieder, nicht meine.	OBJ
Faucis Forscher fügen hinzu: “Chloroquin kann die Etablierung der Infektion und die Ausbreitung von SARS-CoV wirksam reduzieren.	OBJ
Wir hatten ja schon einmal eine „Pandemie“: Die Schweinegrippe 2009.	SUBJ
In den großen Medien dominiert ein Steinwurf in Richtung eines ARD-Teams die Berichterstattung über die Corona-Großkundgebung.	SUBJ
Britische Medien nannten am Sonntagmittag den Namen eines libyschen Flüchtlings, der vor mehreren Jahren nach Großbritannien gekommen sei, auch schon im Gefängnis gesessen habe und einmal wegen des Mitführens einer Waffe eine Geldstrafe bekam.	OBJ
Er ist nicht nur Gründer des kritischen Ärztenetzwerkes «Aletheia».	SUBJ
Details dazu finden sich hier und hier.	OBJ
Das Ergebnis einer Studie mit Zellkulturen ist sowohl für mRNA- und Vektor-Injektionen wie auch für SARS-CoV-2-Infektionen relevant.	OBJ
Prof. Burkhardt liefert hierzu eine Zusammenfassung seiner neuesten histopathologischen Erkenntnisse nach der Untersuchung von fünfzehn Patienten, die innerhalb weniger Tage bis Monate nach der Impfung starben.	OBJ
Interessant dürften auch die Wahnsinnsbeschlüsse zu Fragen der EU von Maastricht bis Schengen sein, inkl. Lissabon, ESM usw.	SUBJ
Menschen, die tagelang ohne Strom und Versorgung auskommen müssen, warten sehnlichst auf Helfer, Nahrung und Trinkwasser.	OBJ
Die Fahrzeuge und Haltestellen werden regelmäßig gründlich gereinigt, darüber hinaus sind täglich mobile Hygieneteams von Hochbahn, S-Bahn und VHH im HVV im Einsatz.	OBJ
Das PEI schreibt zu dem „Einzelfall“ lediglich:    Dem Paul-Ehrlich-Institut wurde ein Fall einer ADEM bei einer 29-jährigen Frau einen Tag nach Impfung mit Vaxzevria berichtet.	OBJ
Das Durchschnittsalter der Coronatoten liegt bei 83 Jahren, also über der aktuellen Lebenserwartung unseres Landes.	OBJ
Es sei zu wenig, dass es ein verbindliches Testangebot und keine richtige Testpflicht geben soll.	SUBJ
Nach diesem Lehrgang seien bei 19 von 21 Teilnehmern Corona-Infektionen festgestellt worden, erklärte Miller.	OBJ
Wie bei Grippewellen auch gibt es bei Covid-19 natürliche Verläufe, die sich dadurch auszeichnen, dass sich zu Beginn die Infektion schnell ausbreitet, um dann nach einer „Pause“ eine Folgewelle zu generieren.	OBJ
So verhielt es sich vergan­genes Jahr zu Ramadan im April, wo der Lock­down zehn Tage vor Beginn gelo­ckert wurde, und auch zum Opfer­fest im August.	OBJ
Dort wird – anders als bei der Staats-Sendeanstalt – noch eine weitere Partei aufgewiesen, nämlich die Freien Wähler.	OBJ
POTUS und das Verteidigungsministerium haben die Amtseinführung des Präsidenten am 20. Januar verschoben .	OBJ
"""In Teilen Griechenlands herrscht offenbar ein rechtsfreier Raum"", sagte der Geschäftsführer von Reporter ohne Grenzen, Christian Mihr, am Dienstag."	OBJ
Auf welcher Seite würden Sie sich verorten?	OBJ
Während ich noch auf der Kontoseite war, klingelte mein Telefon.	OBJ
Niemand weiß genau, wieviele Menschen die Krise in den Freitod getrieben hat.	SUBJ
Italien hat die zweitälteste Bevölkerung weltweit.	OBJ
Die hohe Sterberate liege einfach daran, dass man so viele alte Menschen impfe, die ja sowieso gestorben wären: „Wenn Sie in einer Gruppe von Menschen impfen, die sowieso ein statistisch hohes Risiko haben, in nächster Zeit zu sterben, dann kann es natürlich auch sein, dass jemand im engeren zeitlichen Zusammenhang mit der Impfung stirbt.“ – so allen Ernstes Thomas Mertens, Virologe und Vorsitzender der Ständigen Impfkommission (STIKO).	SUBJ
Am Ende des Tages tragen wir alle die Verantwortung für unser Leben und das Leben unserer Kinder und die Konsequenzen, wenn der Stich schiefgeht.	SUBJ
Es gibt also eine große Gruppe von Milliardären und Millionären, die viele, viele Male die Entwicklung und Ausführung dieser Produkte koordiniert haben.	SUBJ
Selbst in Italien, das als abschreckendes Beispiel hingestellt wird und mit Horrorzahlen aufwartete, widersprechen die Ärzte und sagen, dass auch da bei weitem nicht alles Covid-19-Tote waren, die als solche in die Statistik eingingen.	SUBJ
In den USA wird schon diskutiert, ob Wissenschaftskritik als „hate crime“ (Verbrechen aus Hass) gelabelt werden sollte.	SUBJ
Doch der größte Rückgang der zur Verfügung stehenden Intensiv-Betten steht im zeitlichen Zusammenhang mit den Änderungen der Abrechnungsmodalitäten.	OBJ
Es kursieren erschreckende Videos und Bilder von Menschen, die an einer Pilzvergiftung erkrankt sind und denen danach das halbe Gesicht rausgeschnitten wird.	OBJ
Palmer: Das exakt zu beschreiben übersteigt meine Kompetenz als Rathauschef.	SUBJ
Seehofer präsentierte auch einen eigenen Vorschlag zur Reform des Asylrechts, den er mit den Staaten an der südlichen Außengrenze abgestimmt hatte.	OBJ
Weder in der medialen und politischen Impf-Propaganda, noch durch das impfende medizinische Personal selbst.	SUBJ
Dabei solle man sich einmal fragen, wieso sie sich – so wie ein großer Teil des restlichen Gesundheitspersonals – nicht impfen lässt.	SUBJ
"Diese ""Kollateralschäden"" könnten weit schlimmere Folgen verursachen als das Coronavirus selbst."	OBJ
In Deutschland haben wir seit dem 2. November 2020 einen Lockdown, seit dem 16. Dezember 2020 den kompletten Lockdown, der dann wieder etwas gelockert wurde um schließlich in die “Bundesnotbremse” zu münden.	SUBJ
"Möglicher Corona-Impfzwang spaltet Bevölkerung tief ""64 Prozent der Befragten für generelle Impf-Pflicht"", meldete RTL unter Berufung auf eine Umfrage des SPD-nahen Instituts FORSA gestern."	OBJ
"""Deutschland wäre der größte Verlierer, wenn wir keine Einigung finden"", warnte Knaus."	OBJ
Wichtig sei, dass sich Zustände wie während der Flüchtlingskrise 2015 nicht wiederholten.	OBJ
Damit sind wir bei einem bedingungslosen Grundeinkommen, zumindest vorübergehend für ein halbes Jahr.	SUBJ
Sie sind oft kuppelförmig oder faltbar („Kaffeefilterform“, „Entenschnabelform“) und schützen den Träger der Maske vor Partikeln, Tröpfchen und Aerosolen.	OBJ
So sagt Sigurd Hortemo, Chefarzt der norwegischen Arzneimittelbehörde:  Auf der Grundlage dieser Berichte können wir nicht ausschließen, dass häufige Nebenwirkungen wie Fieber und Übelkeit zu einem ernsteren Verlauf und tödlichem Ausgang bei einigen gebrechlichen Patienten mit schweren Grunderkrankungen beitragen können	OBJ
Das Fälschen von Totenscheinen kann als Ordnungswidrigkeit oder Falschbeurkundung nach §271 StGB angesehen werden.	OBJ
Das RKI schreibt von Todesfällen „im Zusammenhang mit einer COVID-19-Erkrankung“.	OBJ
Ein Flugticket für einen internationalen Qantas-Flug würde es nur noch mit einem entsprechenden Covid-19-Impfnachweis geben.	OBJ
Bei den daraufhin veranlassten Tests der örtlichen Gesundheitsbehörden wurde bis Sonntagnachmittag bei mehr als 50 der insgesamt 260 Mitarbeiter des Schlachthofs ein positives Ergebnis festgestellt.	OBJ
Nämlich, dass die Herkunft des Täters in vielen Bundesländern nicht in den Statistiken auftaucht.	OBJ
Britisches Gesundheitsamt lässt Bombe platzen: GEIMPFTE STERBEN 3-MAL HÄUFIGER AN DELTA-VARIANTE !!!	SUBJ
Dies hat in den vergangenen Monaten immer wieder zu Nachfragen bei den Trägern der gesetzlichen Unfallversicherung geführt - insbesondere hinsichtlich der Tragedauer und Erholungszeiten.	OBJ
Doch gäbe es bisher noch keine systematischen und vergleichbaren Studien zu dem Thema.	OBJ
Nach Stationen bei Börse Online in München und als Korrespondent beim „Focus“ in Frankfurt schreibt er seit 2006 als Investment Writer und freier Autor u.a. für die „Welt“-Gruppe, Cash und den Wiener Börsen-Kurier.	OBJ
Wissenschaftlerinnen, die einen anderen Umgang mit Corona fordern, bekommen immer noch keine adäquate Bühne bei den öffentlich-rechtlichen Medien, wie die zum Teil diffamierende Berichterstattung zur Aktion #allesaufdentisch wieder gezeigt hat.	SUBJ
Aber die Leute misstrauen mittlerweile dem ganzen Theaterdonner und suchen nach echten Informationen.	SUBJ
Schon 2005 konnten Virologen der Universitäten in Tübingen und Münster sowie auch das Helmholtzzentrum in München diese Wirksamkeit gegen Viren bestätigen, berichtet das Haller Kreisblatt.	OBJ
Die Autorengruppe ist eine Kooperation von Wissenschaftlern des Helmholtz-Zentrums für Infektionsforschung, der Medizinischen Hochschule Hannover und der Universität Bonn sowie 23 Mediziner und Forscher des Erasmus Medical Center in Rotterdam.	OBJ
Es sind keine Daten verfügbar bezüglich der Austauschbarkeit des COVID-19-Impfstoffs von Pfizer und BioNTech mit anderen COVID-19-Impfstoffen, um die vollständige Impfung abzuschließen.	OBJ
Dort wähnten sie sich sicher – ein tragischer Trugschluß.	SUBJ
Nachdem in der Nacht die Masse dieser ahnungs- und wehrlosen Menschen zu lebenden Fackeln entzündet, von giftigen Rauchgasen erstickt und zu Brandleichen von der Größe eines Hundes verschmort worden waren, wurden am Morgen des folgenden Tages Zehn-tausende Überlebender im Großen Garten und auf den Elbwiesen von Tieffliegern eiskalt zusammengeschossen und niedergemäht.	SUBJ
Leider ist unbekannt, welche Viruslast (RNA-Kopien/ml) der Ct-Wert 25 hier entspricht (Ct-Werte sind nicht standardisiert; vgl. weiter unten).	OBJ
Zuvor hatte das Land bereits die Einfuhr von amerikanischem Mais und amerikanischen Sojabohnen verboten.	OBJ
Und – Achtung – all das „unabhängig von der behaupteten Spezifität“: Spezifität eines diagnostischen Testverfahrens ist die Wahrscheinlichkeit, dass Gesunde auch wirklich als gesund erkannt werden.	SUBJ
Wie die Autoren dieses Artikels im International Journal of Clinical Practice bemerkten, haben frühere Coronavirus-Impfstoffbemühungen – gegen das Coronavirus des schweren akuten respiratorischen Syndroms (SARS-CoV), das Coronavirus des respiratorischen Syndroms des Nahen Ostens (MERS-CoV) und das Respiratory Syncytial Virus (RSV) – ernste Bedenken an den Tag gebracht.	OBJ
Oder hat so ein Kontakt stattgefunden und gab es Gespräche unter den Verteidigungsministern, Außenministern, vonseiten des Kanzleramtes?	OBJ
Wie es aussieht, nimmt die große Schmelze weiter ihren Lauf.	SUBJ
Doch wie funktioniert eigentlich die Ermittlung des Impfstatus.	SUBJ
40 Prozent der sexuellen Übergriffe gehen auf das Konto von Migranten, bei besonders schweren Fällen – wenn sie besonders erniedrigend oder gemeinschaftlich erfolgt sind – liegt der Anteil ausländischer Täter sogar bei 54 Prozent.	OBJ
Das Problem nur: Für die Behauptung gibt es keine wissenschaftliche Grundlage.	SUBJ
Zur Bedeutung einer „dringenden Empfehlung“ – als solche wurde das Schreiben ja in Umlauf gebracht – hat das Verwaltungsgericht Wiesbaden in einem Schulurteil über Masken festgehalten:  „Die dringende Empfehlung (der Schule) gehe über eine einfache Bitte oder Empfehlung hinaus.	OBJ
Die meisten sind leicht zu erkennen, andere allerdings weniger.	OBJ
"Söder hatte gesagt, die neue Ampel-Mehrheit dürfe sich ""nicht wegducken""."	OBJ
Die beginnt in sechs Wochen, doch nun kommen ganz andere Töne vom Bundesinnenminister.	SUBJ
NACHTRAG: Die beiden Wissenschaftler haben inzwischen eine Klarstellung veröffentlicht, die an dieser Stelle wiedergegeben werden soll: „Es ist kein logischer Widerspruch, dass eine positive Korrelation vorliegt, ohne dass man einen negativen Effekt der Impfquote auf die Übersterblichkeit unterstellen muss.	OBJ
Denn schlecht qualifizierte und wenig verdienende Menschen leiden nicht nur verstärkt unter chronischen Krankheiten, sondern sterben auch früher.	SUBJ
Experimentelle Untersuchungen und Beobachtungen zeigen jedoch, dass die Immunantwort auf die Impfstoffe ganz anders ausfällt als die Reaktion auf eine Infektion mit SARS-CoV-2.	OBJ
„Es ist einfach eine Frechheit, dass wir in einem so gut entwickelten Land wie Deutschland, schlechteres Internet haben als z.B. Albanien!“	SUBJ
Tatsächlich sagte er etwas ganz anderes.	SUBJ
Was sollte diese Studie eigentlich zutage fördern, wenn nicht Fantasiezahlen, mit denen Covid 19 gefährlicher gemacht wird, als es ist?	SUBJ
(Das heißt, wenn man sich von einer Virusinfektion, z.B. Masern, erholt hat, ist man immun und erkrankt nicht mehr).	OBJ
In einem funktionierenden Diskurs würden unsere Medien ihn zum Streitgespräch einladen.	SUBJ
In dem Bericht heißt es:Ein hoher Anteil der Menschen, die im Rahmen der bishe­rigen Impf­kam­pagne geimpft wurden, ist sehr alt, und viele von ihnen hatten auch bereits bestehende medi­zi­ni­sche Erkran­kungen.	OBJ
Das klingt eher nach einem Alibi und einer Entschuldigung der medizinischen Behörden, da seit den 1990er Jahren die Giftigkeit des Spikes bekannt ist und unter anderem seine Fähigkeit, das Gehirn zu durchdringen und Schaden anzurichten.	SUBJ
Da es sich um einen Ausbruch in einem Krankenhaus handelte, war der Zeitpunkt der Infektion vermutlich in den meisten Fällen derselbe.	OBJ
US-Präsident Donald Trump sind die Pflicht-Impfungen in den USA seit Beginn seiner Präsidentschaft ein Dorn im Auge.	OBJ
 Im Journalismus wird Information durch „Haltung“ ersetzt, in der Politik haben hauptsächlich Leute das Sagen, die von ihrer Wiederwahl abhängig sind, weil sie keinen Beruf, etliche nicht mal eine ordentliche Ausbildung haben.	SUBJ
Solche Diagnosen seien bei einer herkömmlichen Leichenschau normalerweise nicht erkennbar, so die Mediziner, insbesondere nicht als Auswirkungen eines Impfschadens.	OBJ
Die Idee hinter Bitcoin Circuitist unkompliziert: Wirklich  Jedem die Möglichkeit bieten, sich am Kryptowährungs-Boom zu beteiligen, der trotz dem, was die meisten Menschen denken oder glauben, immer noch die lukrativste Investition des 21. Jahrhunderts ist.	SUBJ
Als diese zurück­gingen, bewegten sich ab Mai auch die Sterbe­fallzahlen etwa auf dem mittleren Niveau der vier Vorjahre.	OBJ
Durch die Zusammenfassung von nationalen und internationalen Beobachtungen kann sichergestellt werden, dass auch Risiken von Impfstoffen erfasst werden, die so selten sind, dass sie erst bei einer sehr großen Anzahl durchgeführter Impfungen sichtbar werden.	OBJ
Zu diesem Zeit­punkt waren schät­zungs­weise 5,4 Millionen Erst­dosen des Impf­stoffs von Pfizer/BioNTech und 1,5 Millionen Dosen des Impf­stoffs der Univer­sität Oxford/AstraZeneca verab­reicht worden, und etwa 0,5 Millionen Zweit­dosen, haupt­säch­lich des Impf­stoffs von Pfizer/BioNTech, waren verab­reicht worden.	OBJ
Ein toller Erfolg der Anwendung von Ivermectin im Großteil von Indien.	OBJ
Die allgemeine weltweite Maskierung könnte für den Träger nicht nur atemberaubend im wahrsten Sinne des Wortes sein, sondern offenbar sogar Wahrscheinlichkeit erhöhen, Corona-Symptome zu entwickeln.	SUBJ
Achtung: Manche Banken lehnen Neukunden mit hohen Einlagen von vornherein ab.	OBJ
Alles dank eines experimentellen Impfstoffs, der nur für den Notfall zugelassen ist.	OBJ
Sie würden nicht an Covid, sondern mit Covid sterben, schildert die Krankenschwester.	OBJ
Eine Intensivschwester wurde jetzt von den ärztlichen Kollegen auf Station massiv unter Druck gesetzt, sich impfen zu lassen, obwohl nach ihren Angaben nur geimpfte Erkrankte auf Station liegen.	OBJ
Sie begrüßte in diesem Zusammenhang die Ankündigung der Hongkonger Regierung, das geplante Auslieferungsgesetz mit China formell zurückzunehmen.	OBJ
Wir impfen die Menschen ungewollt mit einem Giftstoff.“	SUBJ
Ein ständiges Aus- und wieder Anziehen der Mund-Nasen-Bedeckung ist aber auch nicht sinnvoll, da so das Risiko einer Kontamination erhöht wird.	OBJ
In Österreich wurden auf diese Weise zum Beispiel 700 Corona-Tote „generiert“.	OBJ
"Sie halte die Zustände in Griechenland für eine Katastrophe, sagt sie: ""Aber es ist keinem Kind geholfen, wenn ich jetzt irgendwem etwas ausrichte."	OBJ
Doch er findet nicht zur Genüge in der Berichterstattung unserer Rundfunkanstalten statt und war auch nicht Wahlkampfthema.	SUBJ
Während CDU-Chefin Kramp-Karrenbauer mehr Engagement von den Europäern fordert, twittert das Innenministerium.	OBJ
Sein Geschäft sei lahmgelegt gewesen, weil das Schiff nicht habe weiterfahren dürfen.	OBJ
Sie können das testen, indem sie eine beliebige Seite einer beliebigen Zeitung aufschlagen und dann in irgendeinem Artikel jeweils die erste Ziffer aller dort auftauchenden Zahlen notieren.	OBJ
Von Anfang an wurde im öffentlichen Diskurs die Meinung verbreitet, dass nur eine Impfung Abhilfe schaffen kann.	SUBJ
Ebenso seien laut Renz die ICD-Codes für neurologische Probleme um 1.000 Prozent angestiegen, von 82.000 im Fünfjahresdurchschnitt auf 863.000.	OBJ
Es gebe zudem mindestens zehnmal bis zwanzigmal mehr schwer geschädigte Leute.	OBJ
Damit habe er falsche Hoffnungen geweckt, sagte sie.	OBJ
Der Zweite betrifft eine über 90-jährige, direkte Verwandte, die zwar schon sehr alt war, aber recht gesund.	OBJ
Erst wenn Antikörper vorhanden sind, wäre eine Infektion nachweisbar.	OBJ
"In einem Tagesschaubericht lesen wir: „Bei den Testungen zeigte sich, dass die Zahl der positiven Befunde außerhalb der Zerlegung deutlich niedriger sind als in diesem Betriebsteil""."	OBJ
Vielmehr ist das Gegenteil der Fall.	SUBJ
Das Spike-Protein, das sich an den ACE2-Rezeptor der Zelle heftet, ist die erste Stufe des zweistufigen Prozesses, den Viren nutzen, um in Zellen einzudringen.	OBJ
Außerdem von 859 Blutungen über alle Organsysteme verteilt, welche erst in diesem Bericht erwähnt werden.	OBJ
Und Bartens ist kein Volontär, sondern einer der angesehensten Journalisten für die Themen Gesundheit und Wissenschaft in diesem Lande.	OBJ
Zwar ist das Ende dieser Unsicherheit abzusehen: Inzwischen wird jeder Flüchtling an der Grenze registriert, die Zahl der Neuankommenden kann also genau beziffert werden.	OBJ
Da könnte mit relativ geringem Aufwand schnell Klarheit geschaffen werden – wenn es denn erwünscht wäre.	SUBJ
Gemeldet wurden laut dem Bericht bisher für diese Saison insgesamt 13 laborbestätigte Todesfälle im Zusammenhang mit der Grippe.	OBJ
Wenn sie eine Schicht von Blättern am Boden haben, getrocknete Blätter von Jahren, dann ist das eine ideale Vorbereitung.	OBJ
"""Wenn hier nicht alle vorsichtig sind, sind wir schnell wieder in einem exponentiellem Wachstum"", warnte Kurz."	OBJ
Winfried Kretschmann wird dieser Tage zitiert, wie er Weihnachtsmärkte und Silvesterpartys für »vollkommen ausgeschlossen« hält und eine Verschärfung der Zwangsmaßnahmen gegen 99 Prozent der gesunden Bürger ankündigt.	OBJ
Nur so entwickeln wir Hoffnung, den angerichteten gigantischen Scherbenhaufen wieder aufräumen zu können.	SUBJ
Der Lockdown hat die Fallzahlen stark reduziert, wir halten Abstand soweit irgend möglich, es gibt traditionelles Contact-Tracing.	SUBJ
Wir haben jetzt schon die Bestätigung von vielen Schulleitern und Arbeitgebern, dass sie ab Montag keine Masken mehr anordnen werden und können, da jeder der das anordnet „Persönlich in der Haftung steht“ !	SUBJ
Ein aktuelles Beispiel liefert Jan Böhmermann mit seiner Forderung, dem Virologen Hendrik Streeck und Professor Alexander S. Kekulé keine Bühne mehr zu geben, da sie nicht kompetent seien.	SUBJ
In einem Interview sagte er, dass neue Forschungen zeigen, dass „wir einen großen Fehler gemacht haben“ mit den mRNA-Spike-Protein-Impfstoffen.	OBJ
Seit bereits 20 Jahren wird der Wirkstoff gegen Malaria eingesetzt, genau wie Hydroxychloroquin.	OBJ
Der Sicherheitsrat der Vereinten Nationen befasst sich heute mit der Lage in Syrien.	OBJ
Die Alltagsmasken (Stoffmaksen / Halswärmer („Schlauchtücher“) schnitten mit einem durchschnittlicher CO2 -Wert 11.500 ppm (Bereich 5000 – 24.000) und damit 365 Prozent vom Basiswert besonders schlecht ab.	OBJ
Die Krankenhausauslastung ist ein großes Mysterium.	SUBJ
Von denjenigen, die durch die Prüfung fielen, waren 100 % Wahlstimmen für Biden.	OBJ
Der Demokraten-Funktionär Jones wurde beschuldigt, während der umstrittenen Präsidentschaftswahl bei einer illegalen Wahlzettelsammlung mitgearbeitet und damit der Biden-Kampagne geholfen zu haben.	OBJ
Die Ansteckungsrate (7-Tage-R-Wert) wird vom Robert-Koch-Institut (RKI) mit 1,28 angegeben (Vortag: 1,16).	OBJ
Das UKSH hat also für 166 geschaffene Reservebetten Zuschüsse erhalten, obwohl diese Betten real nie existiert haben.	OBJ
StS Seibert: Über genau diese Bewertung hat Frau Adebahr für das Auswärtige Amt gerade schon gesprochen.	OBJ
Die Frage nach dem „Warum?“ ergibt sich aus der Frage: „Wem nützen die falschen Corona-Toten?“	SUBJ
Aber genau das ist nicht der Fall.	SUBJ
Als aktuell infiziert gelten rund 157.915 Personen.	OBJ
Deshalb finden Sie in den MS-Medien, die sich überschlagen haben, als es darum ging, über ein Banner mit der Aufschrift “White Lives Matter” zu berichten, KEINERLEI Berichterstattung zu den Vorgängen der vergangenen Nacht aus Brixton.	SUBJ
Palmer: Stimmt, aber mit Angst hat das nichts zu tun.	SUBJ
Die Impfquote schwankt zwischen 78% bei der jüngsten Gruppe von 20-29 bis auf 93-95% bei ältesten.	OBJ
Wie es der Zufall so will, wird der PCR-Test in China jetzt auch anal durchgeführt, weil die Zuverlässigkeit der Ergebnisse besser sei und selbstverständlich wird diese Praxis in den westlichen Mainstream-Medien umgehend befürwortet.	SUBJ
Ist der falsch beurkundende Arzt gar ein Amtsträger, ist § 348 StGB anzuwenden, welcher die „Falschbeurkundung im Amt“ regelt.	OBJ
Aber vier Tage später, am 1. März, wurde das Mädchen ins Krankenhaus eingeliefert, weil es ernsthaft krank wurde…..	OBJ
"""Es ist unglaublich, wie wir die Situation gemeistert haben."	SUBJ
Kaum beachtet von der Welt­öf­fent­lich­keit, bahnt sich der erste inter­na­tio­nale Straf­pro­zess gegen die Verant­wort­li­chen und Strip­pen­zieher der Corona‑P(l)andemie an.	SUBJ
Die Gruppe der Länder mit Ivermectin Verwendung umfasst 31 Länder mit insgesamt 972,5 Millionen Einwohner.	OBJ
Mit gentechnischen Mitteln werden nun deren Oberflächenproteine durch die Spike-Proteine von SARS-CoV-2 ausgetauscht.	OBJ
Zusatzfrage: Es geht ja aber um eine eher politische Partnerschaft - so habe ich die Franzosen zumindest verstanden -, nicht um Hilfe zum Beispiel für UNRWA.	SUBJ
Kommen wir nun zu unserem gut informierten, zahleninterpretationsfesten und klugen Tanzlehrer, der auch diese Website betreibt.	SUBJ
Maria Paregger erarbeiteten die Studie und führten die Literaturrecherche durch.	OBJ
Maske und Mund-Nasen­schutz führen somit zu weit mehr gesund­heit­li­chen Problemen, als bisher angenommen.	OBJ
Dies zeigen sowohl Daten der WHO als auch des US-Meldesystems VAERS.	OBJ
Vulkanausbrüche führen in der Tendenz zu einer Abkühlung.	OBJ
Am Ende des Tages hatte ich über 3.134 EUR Gewinn gemacht, nicht schlecht von einer Anfangsinvestition von 250 EUR!	OBJ
"""Gleichzeitig steigt auch die Belegung von Krankenhausbetten, insbesondere von Intensivbetten, mit COVID-19-Patienten weiter an."	OBJ
In einer dieser Vorstädte wohnte ich.	OBJ
Man muss dem Gesundheitsministerium zugestehen: Nach anfänglich heftiger Kritik an fehlenden Daten hat man sich bemüht, zentrale Informationen mit dem Dashboard zugänglich zu machen.	SUBJ
Es geht um die informationelle Selbstbestimmung.	SUBJ
