sentence	prediction
Η Επιτροπή, όμως, είναι πολυμελής και η μεσότητα κατά τον Αριστοτέλη είναι μάλλον η καλύτερη προσέγγιση.	SUBJ
Εντοπίστηκαν και διαλύθηκαν τέσσερα υπόγεια εργαστήρια, ερευνήθηκαν 52 εγκληματικές οργανώσεις και συνελήφθησαν 418 άτομα.	OBJ
Latest News	OBJ
Ο βουλευτής Ηλείας του ΠαΣοΚ άσκησε δριμεία κριτική στη στάση της κυβέρνησης απέναντι στις οικογένειες των θυμάτων, σημειώνοντας ότι «τη στιγμή που ο πρωθυπουργός δηλώνει πως σκύβει το κεφάλι μπροστά στους συγγενείς των θυμάτων, ανέχεται την παρουσία υπουργών στο κυβερνητικό σχήμα, οι οποίοι κατηγορούν τους δικηγόρους των θυμάτων ότι το κάνουν για να αποκομίσουν κέρδη».	OBJ
Όσον αφορά τους δανειολήπτες σε ελβετικό φράγκο; μετακυλίεται ο κίνδυνος από τη συναλλαγματική ισοτιμία κατά τα 2/3 στην τράπεζα; με αποτέλεσμα να μειώνεται σημαντικά η οφειλή τους.	OBJ
Με αργούς ρυθμούς υιοθετούν οι επιχειρήσεις την τεχνητή νοημοσύνη; σύμφωνα με έρευνα της Deloitte	OBJ
 Στο τέλος του άρθρου ως Πηγή	OBJ
ΣΧΟΛΙΑ	OBJ
Η επικινδυνότητά τους για την υγεία, διευκρινίζει ο Οργανισμός, είναι ιδιαίτερα υψηλή.	OBJ
Μετά τις 8 μέχρι το πρωί; είχαμε μόνο 5 δονήσεις.	OBJ
Αυτό έχει επηρεάσει τα χρονοδιαγράμματα της συγκομιδής, οδηγώντας σε προβλήματα όπως η καθυστερημένη ωρίμανση των καρπών.	OBJ
Το μήνυμα της Αθήνας στην Αγκυρα είναι πως οι προγραμματισμένες έρευνες των δύο πλοίων για το καλώδιο ηλεκτρικής διασύνδεσης με την Κύπρο θα ολοκληρωθούν κανονικά.	OBJ
Ο πρόεδρος των ΗΠΑ Τραμπ αναίρεσε απόφαση της κυβέρνησης του προκατόχου του Μπάιντεν που παρείχε σε κάπου 600.000 πολίτες της Βενεζουέλας προστασία από την απέλαση.	OBJ
· Οι μισοί από τους ερωτηθέντες λένε ότι συζητούν με τον Διευθύνοντα Σύμβουλο για τα ΑΙ θέματα.	OBJ
«Δεν κρύβουμε τη συμπάθειά μας» για τον Ντόναλντ Τραμπ, πρόσθεσε ο Ναγίμπ Μπουκέλε, κρίνοντας πως είναι «καλή στιγμή για την ενίσχυση της διπλωματικής σχέσης».	OBJ
Τα μάτια στραμένα στο Παρίσι - Τι αναμένεται στη Σύνοδο για την ΑΙ	OBJ
Κυρίως αναβολικά και ορμόνες αλλά και «τεράστια ποσότητα» χαπιών για στυτική δυσλειτουργία καθώς και ένα εργαστήριο παρασκευής τους βρίσκονται, σύμφωνα με πληροφορίες της «Κ», ανάμεσα στα ευρήματα της ΕΛ.ΑΣ. στο πλαίσιο της επιχείρησης της EUROPOL, «SHIELD V», με αντικείμενο το εμπόριο ψευδεπίγραφων φαρμάκων και συναφών σκευασμάτων.	OBJ
? Το 37% αναφέρει ότι εξωτερικοί συνεργάτες; ειδικοί σε θέματα ΑΙ; αναλαμβάνουν την εκπαίδευση των Διοικητικών Συμβουλίων.	OBJ
Κάνε like στη σελίδα μας στο Facebook	OBJ
Παράλληλα ζήτησε από τον Μασκ, ο οποίος έχει χαρακτηρίσει τη USAID «εγκληματική οργάνωση», να μειώσει τον προϋπολογισμό της υπηρεσίας και να «νοικοκυρέψει» τα οικονομικά των ομοσπονδιακών υπηρεσιών.	OBJ
Τα είδη που θα μπορούσαν να επηρεαστούν περιλαμβάνουν τον καφέ και το πετρέλαιο, σύμφωνα με το Euronews.	OBJ
Ποιες κινεζικές εταιρείες AI θα μπορούσαν να... μιμηθούν την DeepSeek	SUBJ
«Την Παρασκευή 7 Φεβρουαρίου στις 23:59 (τοπική ώρα- 06:59 ώρα Ελλάδας το Σάββατο) όλο το προσωπικό που εργάζεται για την USAID θα τεθεί σε αργία παγκοσμίως», ανέφερε η υπηρεσία στην ανακοίνωση που έχει αναρτηθεί στον ιστότοπό της, ο οποίος έχει τεθεί εκτός λειτουργίας από το Σάββατο.	OBJ
Οι ΗΠΑ δεν κάνουν φιλανθρωπίες	OBJ
Σύμφωνα με τη Washington Post, ο υπουργός Οικονομικών Σκοτ Μπέσεντ έδωσε τις ευλογίες του γι' αυτή την ανάληψη του ελέγχου του συστήματος πληρωμών, η οποία δεν κατέστη δυνατή παρά μόνο αφού ένας υψηλόβαθμος δημόσιος αξιωματούχος τέθηκε σε διοικητική αργία επειδή αρνήθηκε να δώσει τα κλειδιά του συστήματος στις ομάδες του Έλον Μασκ.	OBJ
«Δεν έχει αλλάξει κάτι δραματικά.	OBJ
Είναι χαρακτηριστικό πως ο κύριος Ανδρουλάκης κάλεσε τους πολίτες να αναρωτηθούν «αν την Κυριακή δεν είχαν βγει στις πλατείες όλης της χώρας εκατοντάδες χιλιάδες Έλληνες γεμάτοι θυμό και αγανάκτηση για τον τρόπο που η κυβέρνηση έχει χειριστεί την τραγωδία των Τεμπών; θα έδινε τη χθεσινή συνέντευξη ο κ. Μητσοτάκης;	SUBJ
Παράλληλα; σε αυτή τη φάση της επιχείρησης που διήρκεσε από τον Απρίλιο έως τον Νοέμβριο του 2024 εντοπίστηκαν και διαλύθηκαν 4 υπόγεια εργαστήρια; ερευνήθηκαν 52 εγκληματικές οργανώσεις και συνελήφθησαν 418 άτομα.	OBJ
Την ίδια στιγμή βέβαια στρατιωτικές πηγές που μίλησαν στα «ΝΕΑ» επισημαίνουν ότι η κορβέτα που έχουν στείλει οι Τούρκοι είναι από τις παλιές και όχι τις σύγχρονες της κλάσης Ada, και αυτό εκλαμβάνεται ως ένα έμμεσο μήνυμα της Αγκυρας πως δεν έχει καμία διάθεση για περαιτέρω κλιμάκωση.	OBJ
Στην Αυστραλία, η χρήση προγραμμάτων της DeepSeek απαγορεύτηκε στις κυβερνητικές συσκευές λόγω «απαράδεκτου επιπέδου κινδύνου στο ζήτημα της ασφάλειας».	OBJ
Δημοφιλή	OBJ
Μέτρα κατά της κινεζικής εφαρμογής από πολλές χώρες – Επικαλούνται λόγους κυβερνοασφάλειας	OBJ
Στο ελληνικό επιτελείο συνεχίζουν να διατηρούν χαμηλούς τόνους, επισημαίνοντας ότι το γεγονός αυτό, μετά εκείνο της Κάσου προ λίγων μηνών, δείχνει πως είναι στρατηγική επιλογή της Τουρκίας να αμφισβητεί οποιαδήποτε κίνηση της Ελλάδας είναι πέρα από τα 6 ναυτικά μίλια, ασχέτως αν είναι σε περιοχές τις οποίες η Αγκυρα θεωρεί μέρος της «Γαλάζιας Πατρίδας» ή της υφαλοκρηπίδας της, σύμφωνα πάντοτε με τη δική της θεώρηση των πραγμάτων.	OBJ
ΡΟΗ ΕΙΔΗΣΕΩΝ	OBJ
Σύμφωνα με τον ιστότοπο Wired, το αφεντικό των Tesla, X και SpaceX έβαλε νέους που εργάζονται για την DOGE σε κυβερνητικές θέσεις κλειδιά.	OBJ
Τελευταία κίνηση της Αγκυρας σε αυτό το πεδίο αποτελεί η ΝΟΤΑΜ που εξέδωσε χθες με αφορμή ελληνικές ασκήσεις στις 11 και 12 Φεβρουαρίου σε Αη Στράτη και δυτικά της Καρπάθου, ζητώντας την αποστρατιωτικοποίηση των νησιών αυτών.	OBJ
Συνδικάτα και μια οργάνωση υπεράσπισης των ανθρώπινων δικαιωμάτων προσέφυγαν στη δικαιοσύνη στην Ουάσινγκτον κατά αυτής της ανάληψης ελέγχου.	OBJ
Κάποτε, πυκνώνει η ακολουθία σε σύντομο χρόνο, κάποτε αραιώνει.	OBJ
Την περασμένη χρονιά επίσης; εγκαινίασε τη μεγαλύτερη φυλακή στη Λατινική Αμερική; κοντά στην Τεκολούκα; κάπου 75 χιλιόμετρα από την πρωτεύουσα Σαν Σαλβαδόρ.	OBJ
Ο ρυθμός της σεισμικότητας μέχρι στιγμής παραμένει σταθερός»; είπε ο Βασίλης Καραστάθης.	OBJ
Ακολουθήστε το protothema.gr στο Google News και μάθετε πρώτοι όλες τις ειδήσεις	OBJ
«Υπάρχει ροή ρευστών υγρών τα οποία ανεβαίνουν σιγά – σιγά σε μεγάλο βάθος προς την επιφάνεια και πηγαίνουν προς την Άνυδρο.	OBJ
Τη Δευτέρα ο υπουργός Εξωτερικών των ΗΠΑ Μάρκο Ρούμπιο τόνισε ότι η χώρα δεν κάνει «φιλανθρωπίες»; εξηγώντας ότι έχει τεθεί προσωρινά επικεφαλής της USAID και κατηγορώντας το προσωπικό της ότι «δεν είναι διατεθειμένο να απαντήσει σε απλές ερωτήσεις» για τα προγράμματα της υπηρεσίας.	OBJ
«Η αμοιβή θα είναι σχετικά χαμηλή για τις ΗΠΑ αλλά σημαντική για εμάς και θα μας επιτρέψει να κάνουμε βιώσιμο όλο το σύστημα των φυλακών μας», πρόσθεσε ο πρόεδρος του Ελ Σαλβαδόρ.	OBJ
Συγκεκριμένα και σύμφωνα πάντα με πληροφορίες από τη Χαριλάου Τρικούπη; επαναφέρεται στην πρόταση η προστασία της κύριας κατοικίας κατά τα πρότυπα του νόμου του ΠαΣοΚ του 2010 με επικαιροποιημένα κριτήρια και διαδικασίες.	OBJ
Σύμφωνα με τη Χαριλάου Τρικούπη με την συγκεκριμένη που θα καταθέσει το ΠαΣοΚ οι δανειολήπτες αποκτούν δικαίωμα προτίμησης στην αγορά του δανείου υπό συγκεκριμένες προϋποθέσεις, ενώ περιορίζεται η ευθύνη του εγγυητή στην περίπτωση των δανείων που έχουν μεταβιβαστεί και παρέχονται ευνοϊκοί όροι για τη ρύθμιση της οφειλής.	OBJ
Μερικές φορές δεν συμφωνούμε και δεν θα πάμε εκεί όπου θέλει να πάει.	SUBJ
Στο περιθώριο της επίσκεψης του κ. Ρούμπιο; στο πλαίσιο μίνι-περιοδείας του στην κεντρική Αμερική; το πρώτο του ταξίδι στο εξωτερικό αφού ανέλαβε; οι ΗΠΑ και το Ελ Σαλβαδόρ ανακοίνωσαν την υπογραφία συμφωνίας συνεργασίας στο πεδίο της πυρηνικής ενέργειας; που θέλει να αναπτυχθεί στη χώρα ο κ. Μπουκέλε.	OBJ
«Όταν σε ένα κτήριο παρατηρούμε ρωγμές τότε αρχίζουμε να παρατηρούμε μια μεγάλη τρωτότητα», επισήμανε.	OBJ
Εξασφαλίζοντας ανωνυμία στους προμηθευτές, που καλύπτουν τα ίχνη τους στις δαιδαλώδεις διαδρομές του κυβερνοχώρου από την αγορά μέχρι την πώληση, αλλά και σε διευρυμένα ακροατήρια δυνητικών αγοραστών, αποτελούν τον βασικό κανάλι του παράνομου εμπορίου φαρμάκων και συναφών σκευασμάτων που «ανθεί» σήμερα στην Ευρώπη.	SUBJ
«Προτείναμε στις ΗΠΑ (σ.σ. να προχωρήσουν σε) εξωτερική ανάθεση (outsourcing) μέρους του σωφρονιστικού συστήματός τους», ανέφερε μέσω X ο αρχηγός του σαλβαδοριανού κράτους, γνωστός για τη εξαιρετικά σκληρή στάση του έναντι της εγκληματικότητας.	OBJ
Οι ευρωπαϊκές εταιρείες τεχνολογίας χρειάζονται ολοένα και περισσότερο χώρο συνδεδεμένο με την τεχνητή νοημοσύνη	SUBJ
Ο Αμερικανός πρόεδρος χαιρέτισε τη δουλειά του Έλον Μασκ, ο οποίος ξέρει «να περικόπτει τα κόστη.	OBJ
Σχολιασμένα	OBJ
«Τα πρόσωπα τα οποία οφείλουν να μοιράζονται πληροφορίες με την ομοσπονδιακή κυβέρνηση; δεν θα έπρεπε να είναι υποχρεωμένα να τις μοιράζονται και με τον Έλον Μασκ ή με την 'DOGE' του»; υπογραμμίζεται στην προσφυγή.	OBJ
Στο X, ο Έλον Μασκ υποσχέθηκε «ένα εγγυημένο θέαμα» ως απάντηση σε μια ανάρτηση, αναφέροντας ότι η DOGE θα ανακαλύψει «απάτη και διαφθορά σε πρωτοφανή κλίμακα σε πολυάριθμες κυβερνητικές υπηρεσίες».	SUBJ
Στη φυλακή; με ονομαστική χωρητικότητα 40.000 θέσεων; κρατούνται το τρέχον διάστημα κάπου 15.000 άνθρωποι; κατά εκτιμήσεις.	OBJ
Νεαροί συνεργάτες του πιο πλούσιου ανθρώπου στον κόσμο απέκτησαν πρόσβαση στο σύστημα διανομής τρισεκατομμυρίων δολαρίων; προκαλώντας σφοδρές αντιδράσεις  UPD 88	SUBJ
Σε κατάσταση έκτακτης ανάγκης παραμένει ο Δήμος Θήρας μέχρι τις 3 Μαρτίου, ενώ οι επιστήμονες συνιστούν ψυχραιμία μέχρι την αποκλιμάκωση που μπορεί να γίνει «είτε με σεισμό άνω των 5,5 Ρίχτερ είτε με τη συνέχεια της υπό εξέλιξη δραστηριότητας», την οποία ο Ευθύμιος Λέκκας ανέφερε ως σμηνοσειρά.	OBJ
Έχει πει μάλιστα πως έχει σκοπό περίπου 30.000 μετανάστες να μεταφερθούν σε διαβόητη στρατιωτική φυλακή στην αμερικανική ναυτική βάση στον Κόλπο Γουαντάναμο, στην Κούβα.	OBJ
«Φουντώνει» ο εμπορικός πόλεμος ΗΠΑ-Κίνας:	OBJ
Η συνεχιζόμενη σεισμική δραστηριότητα στις Κυκλάδες κρατά σε πλήρη εγρήγορση κατοίκους, κρατικό μηχανισμό και επιστήμονες, που παρακολουθούν το φαινόμενο.	OBJ
● Το 57% υποστηρίζει ότι τα μέλη των Διοικητικών Συμβουλίων εκπαιδεύονται ανεξάρτητα σχετικά με το ΑΙ.	OBJ
Στο Χ, το μέσο κοινωνικής δικτύωσης του οποίου είναι ιδιοκτήτης, ο Μασκ έγραψε πως «ο μόνος τρόπος για να σταματήσει η απάτη και η σπατάλη χρημάτων των φορολογουμένων είναι να μπορούμε να παρακολουθούμε τις ροές των πληρωμών και να μπλοκάρουμε ύποπτες συναλλαγές για να τις εξετάσουμε».	OBJ
«Δεν υπάρχουν νικητές στους εμπορικούς πολέμους», τόνισε χαρακτηριστικά η ύπατη εκπρόσωπος της ΕΕ για Θέματα Εξωτερικής Πολιτικής και Πολιτικής Ασφάλειας.	OBJ
- Στη Σαντορίνη ο Πρωθυπουργός: «Ο κρατικός μηχανισμός στο πλευρό των κατοίκων – Καλύτερα να προετοιμαζόμαστε και να προλαμβάνουμε»	OBJ
Εγινε υπό τη βαριά σκιά της προαναγγελίας του αμερικανού προέδρου Τραμπ για επιβολή δασμών (και) στη σύμμαχο ΕΕ; των επαναλαμβανόμενων αξιώσεών του για αύξηση των αμυντικών δαπανών στο 5% του ΑΕΠ στο ΝΑΤΟ – ενόσω ο ίδιος απειλεί να προσαρτήσει τη Γροιλανδία ακόμη και με τη χρήση στρατιωτικής βίας κατά της συμμάχου Δανίας – και; φυσικά; του σχεδόν τριετούς πολέμου στην Ουκρανία; που φέρει την αρχιτεκτονική ασφαλείας στην Ευρώπη στο επίκεντρο του ρωσικού αναθεωρητισμού.	SUBJ
Αλλά πιστεύω πως κάνει πολύ καλή δουλειά».	OBJ
Αν και στη συνέχεια ο Petro δέχθηκε αυτούς τους μετανάστες; η αβεβαιότητα στην αγορά του καφέ παρέμεινε.	SUBJ
Ε. Λέκκας: Απίθανο το σενάριο για μέγιστο σεισμό 6 Ρίχτερ και κάτω	OBJ
Σύμφωνα με τη Washington Post; ο υπουργός Οικονομικών Σκοτ Μπέσεντ έδωσε τις ευλογίες του γι' αυτή την ανάληψη του ελέγχου του συστήματος πληρωμών; η οποία δεν κατέστη δυνατή παρά μόνο αφού ένας υψηλόβαθμος δημόσιος αξιωματούχος τέθηκε σε διοικητική αργία επειδή αρνήθηκε να δώσει τα κλειδιά του συστήματος στις ομάδες του Έλον Μασκ.	OBJ
«Πικρίζουν» οι τιμές του καφέ -Ο ρόλος Τραμπ και η Βραζιλία	OBJ
Λιανγκ Ουενφένγκ:	OBJ
Διακυβέρνηση, Διοικητικά Συμβούλια και αποτελεσματικοί τρόποι υιοθέτησης του AI	OBJ
Ανακοινώθηκε το νέο μοντέλο τεχνητής νοημοσύνης Gemini 2.0 της Google	OBJ
Κατά τον πολωνό πρωθυπουργό Ντόναλντ Τουσκ  η χώρα του οποίου ασκεί την εκ περιτροπής εξάμηνη προεδρία της ΕΕ  οι «27» πρέπει να αποφύγουν «εντελώς περιττούς και ανόητους δασμολογικούς πολέμους» και το «σκληρό παράδοξο» να μπουν σε εμπορικό πόλεμο με έναν μακροχρόνιο σύμμαχο.	SUBJ
Στη Γαλλία; η Εθνική Επιτροπή Πληροφορικής και Ελευθεριών (Cnil) όπως και η ρυθμιστική αρχή της Ιρλανδίας; ανακοίνωσαν την πρόθεσή τους να ζητήσουν πληροφορίες από την κινεζική εταιρεία όσον αφορά την προστασία των δεδομένων.	OBJ
Τα κόμματα στα αριστερά της Νέας Δημοκρατίας στρέφουν τα βέλη τους στον πρωθυπουργό και δείχνουν να εναρμονίζονται με τη λαϊκή απαίτηση για απονομή δικαιοσύνης στο δυστύχημα που στέρησε τη ζωή σε 57 συμπολίτες μας, στην πλειοψηφία τους νέα παιδιά.	SUBJ
«Σε μια εποχή που η Τεχνητή Νοημοσύνη εφαρμόζεται από όλους τους οργανισμούς, είναι επιτακτική ανάγκη τα μέλη των Διοικητικών Συμβουλίων να συνεχίσουν να επενδύουν σε επιμόρφωση και πόρους για να βελτιώσουν το επίπεδο γνώσης τους για το ΑΙ.	OBJ
Για το προσωπικό της USAID που βρίσκεται στο εξωτερικό η Ουάσιγκτον σχεδιάζει, σε συνεργασία με το Στέιτ Ντιπάρτμεντ, να καταβάλει χρήματα για την επιστροφή τους στις ΗΠΑ μέσα σε 30 ημέρες, επεσήμανε η ανακοίνωση.	OBJ
Εύη Νομικού:	OBJ
? 8% των ερωτηθέντων προσλαμβάνουν ειδικούς σε θέματα ΑΙ ως νέα μέλη του Διοικητικού Συμβουλίου.	OBJ
Η απειλή από τον Τραμπ ακολούθησε την κίνηση του Κολομβιανού Προέδρου Γκουστάβο Πέτρο να αρνηθεί να δεχτεί δύο αμερικανικές στρατιωτικές πτήσεις που μετέφεραν μετανάστες πίσω στην Κολομβία.	OBJ
Την αρνήθηκε η Νέα Δημοκρατία, αλλά σήμερα δηλώνουν ότι δεν θα μπουν εμπόδιο στη σύσταση προανακριτικής επιτροπής.	OBJ
● Το 44% των ερωτηθέντων θεωρεί ότι ο ρυθμός υιοθέτησης του ΑΙ πρέπει να επιταχυνθεί.	OBJ
Πρόβλημα... χώρου στα data centers της Ευρώπης λόγω τεχνητής νοημοσύνης	SUBJ
«Η προοπτική και ο στόχος μας θα πρέπει να είναι πώς θα οδηγηθούμε σε συνεργασία»; δήλωσε σε ανάλογο μήκος κύματος ο απερχόμενος καγκελάριος της Γερμανίας Ολαφ Σολτς; η χώρα του οποίου θα πληγεί περισσότερο από έναν εμπορικό πόλεμο με τις ΗΠΑ.	OBJ
E. Λέκκας: Ελάχιστα πιθανό το σενάριο των 6 Ρίχτερ – Οι πολίτες να δίνουν βάση μόνο στις επιστημονικές ανακοινώσεις	OBJ
Προ της συνόδου, μάλιστα, η Πολωνία και οι χώρες της Βαλτικής κυκλοφόρησαν έγγραφο, με το οποίο καλούν την ΕΕ να δαπανήσει τουλάχιστον 100 δισεκατομμύρια ευρώ για την άμυνα έως το 2027, συμπεριλαμβανομένης της αγοράς όπλων από συμμάχους του ΝΑΤΟ εκτός ΕΕ.	OBJ
Ο κ. Γεραπετρίτης διόρισε τριμελή επιτροπή με καθηγητές, οι οποίοι συμφώνησαν ότι υπάρχει άμεση αιτιότητα καθώς αν υπήρχε τηλεδιοίκηση, τα δύο τρένα -ακόμη και αν είχαν μπει στην ίδια γραμμή-, δεν θα είχαν συγκρουστεί ποτέ.	OBJ
Αυτό είναι το μεγάλο ερώτημα που δείχνει ότι ο Πρωθυπουργός συμπεριφέρεται με έναν αναξιόπιστο τρόπο».	SUBJ
Τα συμβόλαια μελλοντικής εκπλήρωσης του καφέ Arabica αυξήθηκαν κατά 6;55% την προηγούμενη εβδομάδα και 15;14% τον προηγούμενο μήνα.	OBJ
Ειδήσεις	OBJ
Στη Νότια Κορέα, τα υπουργεία Άμυνας και Εμπορίου ανακοίνωσαν ότι απέκλεισαν την πρόσβαση της DeepSeek στους υπολογιστές τους, εν αναμονή διευκρινίσεων από την κινεζική startup για τη διαχείριση των πληροφοριών που συλλέγονται από τους χρήστες.	OBJ
Υπογραμμίζεται πως «με βάση τους εργαστηριακούς ελέγχους που πραγματοποιήθηκαν από τον ΕΟΦ σε γνωστοποιημένα και μη συμπληρώματα διατροφής που διαβιβάστηκαν στο πλαίσιο καταγγελίας ή κατασχέθηκαν από διωκτικές αρχές, προέκυψαν μη συμμορφώσεις με τη νομοθεσία, οι κυριότερες από τις οποίες συνίστανται σε:	OBJ
Η εκστρατεία αυτή, που του χάρισε τεράστια δημοτικότητα, μείωσε σε εντυπωσιακό βαθμό την εγκληματικότητα, ωστόσο επικρίνεται έντονα από οργανώσεις υπεράσπισης των ανθρωπίνων δικαιωμάτων.	SUBJ
Αυτή η επένδυση θα επιτρέψει στους οργανισμούς να συμβαδίζουν με τις εξελισσόμενες τάσεις της Τεχνητής Νοημοσύνης και να έχουν σαφές πλεονέκτημα στην αντιμετώπιση των κινδύνων και στη σύνδεση του ΑΙ με την στρατηγική και τις προτεραιότητες των επιχειρήσεων».	OBJ
Η μετοχή της AMD υποχώρησε περίπου 6% στις εκτεταμένες συναλλαγές καθώς η εταιρεία έχασε τις εκτιμήσεις για το βασικό της τμήμα των data center	OBJ
η ακολουθία συνεχίζει σε αυτές τις τέσσερις μέρες με την ίδια ένταση.	OBJ
Ειδήσεις σήμερα:	OBJ
Στο ίδιο μήκος κύματος ήταν και η ραδιοφωνική παρέμβαση του Μιχάλη Κατρίνη.	OBJ
Σε αυτό το πλαίσιο, προσκλήθηκαν ο μεν γενικός γραμματέας του ΝΑΤΟ Μαρκ Ρούτε σε γεύμα εργασίας με τους «27», ο δε βρετανός πρωθυπουργός, Κιρ Στάρμερ (πρώτη φορά μετά το Brexit).	OBJ
«Κάνουμε ό,τι μπορούμε, και άλλοι συνάδελφοι, από διάφορα κέντρα, να βελτιώσουμε την παρακολούθηση για να σας δίνουμε και πιο αξιόπιστες πληροφορίες.	OBJ
Αν και οι επενδύσεις των επιχειρήσεων στην Τεχνητή Νοημοσύνη αυξάνονται παγκοσμίως; πολλά Διοικητικά Συμβούλια δεν γνωρίζουν πώς να αξιοποιήσουν τη χρήση της.	OBJ
Τα πολιτικά γεγονότα μετά τα ογκώδη συλλαλητήρια της Κυριακής, που έγιναν με αφορμή την υπόθεση των Τεμπών, είναι πυκνά.	SUBJ
Ακόμα και μια ισχυρότερη δόνηση θα είχε σχετικά πλέον περιορισμένες επιπτώσεις	OBJ
Τα έντονα καιρικά φαινόμενα, τα οποία περιλαμβάνουν ακραίους καύσωνες, ξηρασίες και παγετούς, επιδείνωσε επίσης την κατάσταση.	OBJ
Νέα Agentic AI πλατφόρμα από την AustriaCard	OBJ
Η δημοκρατική γερουσιαστής Ελίζαμπεθ Γουόρεν, μέλος της επιτροπής της Γερουσίας που είναι αρμόδια για τις τράπεζες, σε επιστολή της προς τον Μπέσεντ χαρακτήρισε την κατάσταση «εξαιρετικά επικίνδυνη».	OBJ
Το σύστημα πληρωμών του Γραφείου Χρηματοοικονομικών Υπηρεσιών του υπουργείου Οικονομικών διαχειρίζεται τις ροές των ομοσπονδιακών κεφαλαίων, περιλαμβανομένων των 6 τρισεκατομμυρίων δολαρίων που προορίζονται κάθε χρόνο για τις συντάξεις, το πρόγραμμα υγειονομικής ασφάλισης Medicare, τους μισθούς των ομοσπονδιακών υπαλλήλων και άλλες ουσιώδεις δαπάνες.	OBJ
Θα πρέπει να κάνουν οι κάτοικοι εδώ μια μικρή υπομονή; ίσως και την επόμενη εβδομάδα.	SUBJ
«Εάν δεχθούμε επίθεση σε εμπορικά θέματα», τόνισε ο γάλλος πρόεδρος Εμανουέλ Μακρόν, «η Ευρώπη ως ισχυρή δύναμη, πρέπει να αντιδράσει».	OBJ
Τούτων λεχθέντων, σε ξεχωριστή διμερή συνάντηση που είχαν χθες στις Βρυξέλλες, ο μεν ΓΓ του ΝΑΤΟ υπογράμμισε ότι η ευρωπαϊκή άμυνα χωρίς τις ΗΠΑ «δεν θα λειτουργήσει», ο δε βρετανός πρωθυπουργός Στάρμερ ξεκαθάρισε ότι η χώρα του «δεν επιλέγει μεταξύ ΗΠΑ και ΕΕ».	OBJ
Οι συγκομιδές Arabica από την Κολομβία και την Κεντρική Αμερική παρουσιάζουν επίσης μεγαλύτερες καθυστερήσεις στην κυκλοφορία τους στην αγορά, κυρίως λόγω των έντονων βροχοπτώσεων σε αυτές τις περιοχές.	OBJ
Ο υδρογραφικός σταθμός Ηρακλείου ανανέωσε και διεύρυνε τη Navtex για το «Ievoli Relume» έως τις 5 Φεβρουαρίου, προσθέτοντας και μια νέα γραμμή πλεύσης μεταξύ Κρήτης και Κάσου, η οποία μισή είναι στα διεθνή και μισή στα εθνικά χωρικά ύδατα.	OBJ
Για την ορθή χρήση του ΑΙ στην εταιρική διακυβέρνηση, είναι σημαντικό, τα μέλη των Διοικητικών Συμβουλίων, να διαθέτουν επαρκή χρόνο και να ενημερώνονται πλήρως σχετικά με αυτό το θέμα.	OBJ
Επομένως; πρέπει και στη δημόσια επικοινωνία μας να ισορροπούμε μεταξύ της ανάγκης; να είμαστε παρόντες και να δρούμε προληπτικά χωρίς όμως ταυτόχρονα να αναπαράγουμε σενάρια καταστροφής τα οποία ενδεχομένως μπορεί να τρομάξουν κάποιους επισκέπτες»; τόνισε μεταξύ άλλων ο κ. Μητσοτάκης.	OBJ
Σε σχέση με την ακολουθία:	OBJ
Αυτοί οι άνθρωποι του Μασκ, ηλικίας από 19 ως 24 ετών, σύμφωνα με τον αμερικανικό Τύπο, διορίσθηκαν επίσης στους κόλπους του Γραφείου Διαχείρισης Προσωπικού, την υπηρεσία ανθρώπινων πόρων των δημοσίων υπαλλήλων, που τους έστειλε την περασμένη εβδομάδα ηλεκτρονική επιστολή προτείνοντάς τους να παραιτηθούν με αποζημίωση μισθούς εννέα μηνών.	OBJ
Σκέψεις να στέλνονται στο Ελ Σαλβαδόρ μέλη συμμοριών από τη Λατινική Αμερική	OBJ
Δείτε όλες τις τελευταίες Ειδήσεις από την Ελλάδα και τον Κόσμο, τη στιγμή που συμβαίνουν, στο Protothema.gr	OBJ
· Μόνο το 3% των ερωτηθέντων απάντησε ότι η επιχείρησή τους είναι πραγματικά έτοιμη να αναπτύξει το ΑΙ, ενώ το 41% εκτιμά ότι δεν είναι (ή θεωρεί το αντίθετο).	OBJ
Η Σαντορίνη είναι ένας εμβληματικός τουριστικός προορισμός και είναι χρέος μας να διαφυλάξουμε τη φήμη της και να είμαστε σίγουροι ότι και το 2025 θα είναι μια εξαιρετική χρονιά για τον τουρισμό του νησιού.	SUBJ
Microsoft, Google και Meta Platforms έχουν προβλέψει αθροιστικά κεφαλαιουχικές δαπάνες τουλάχιστον 215 δισεκατομμυρίων δολαρίων για to 2025	OBJ
Είναι μια προσωπική άποψη.	OBJ
Επισήμανε, επίσης, τις αντιφάσεις κυβερνητικών στελεχών, που «άλλοτε έλεγαν ότι είναι μπαγιάτικη υπόθεση, άλλοτε ότι κρίθηκε στις εκλογές, άλλοτε ότι δεν υπάρχει λόγος να ασχολούμαστε, ενώ τώρα ο πρωθυπουργός αναγκάζεται να παραδεχθεί ότι τα πράγματα δεν είναι όπως τα παρουσίαζε αρχικά» δήλωσε χαρακτηριστικά.	SUBJ
Ορισμένοι ηγέτες υιοθέτησαν ωστόσο πιο συμβιβαστικούς τόνους.	SUBJ
Η πτώση αυτή της σεισμικότητας δεν πρέπει, όμως, να εκλαμβάνεται ως στοιχείο ότι άλλαξαν τα πράγματα αιφνιδίως.	SUBJ
Ο Πρωθυπουργός, συνοδευόμενος από τον Υπουργό Κλιματικής Κρίσης και Πολιτικής Προστασίας Βασίλη Κικίλια, μετέβη στο Κινητό Επιχειρησιακό Κέντρο «Όλυμπος», το οποίο βρίσκεται στο νησί από τις αρχές της εβδομάδας, όπου ενημερώθηκε από τον Αρχηγό του Πυροσβεστικού Σώματος Αντιστράτηγο Θεόδωρο Βάγια για τον σχεδιασμό που έχει καταρτιστεί σε περίπτωση έκτακτης ανάγκης, για τους προληπτικούς ελέγχους που έχουν γίνει σε δημόσια κτήρια και για τις παρεμβάσεις σε σημεία όπου υπάρχει αυξημένος κίνδυνος κατολισθήσεων.	OBJ
? Το 80% των ερωτηθέντων ανέφεραν ότι τα Διοικητικά τους Συμβούλια έχουν περιορισμένη; ελάχιστη ή καθόλου γνώση και εμπειρία γύρω από την Τεχνητή Νοημοσύνη.	OBJ
Παράλληλα επισήμανε ότι στη Νέα Καμένη εγκαθίστανται νέοι σεισμογράφοι, το απόγευμα στο Γαβρίλο θα μπει ένας νέος σεισμογράφος ενώ στη Θηρασιά θα μπει νέος σεισμογράφος αύριο Σάββατο.	OBJ
Ερωτηθείς για το εάν ο πρωινός σεισμός στην Πάτρα συνδέεται με τη σεισμική ακολουθία στις Κυκλάδες απάντησε αρνητικά λέγοντας ότι «είναι τελείως ανεξάρτητα γεγονότα».	OBJ
Πτώση στη σεισμικότητα διαπιστώθηκε τη νύχτα στη Σαντορίνη και όπως ενημερώνει ο διευθυντής του Γεωδυναμικού Ινστιτούτου, Βασίλης Καραστάθης είναι στο πλαίσιο φυσικής εξέλιξης και δεν πρέπει να εκλαμβάνεται ως αιφνίδια αλλαγή.	OBJ
Κατά συνέπεια ο Αμερικανός πρόεδρος δεν έχει τη δικαιοδοσία να την καταργήσει χωρίς την έγκριση του Κογκρέσου.	OBJ
Όπως είπα; δεν “ψυχανεμιζόμαστε” στην επιστήμη.	SUBJ
Παράλληλα; τα όσα είπε για το ενδεχόμενο να υπήρχε παράνομο φορτίο στην εμπορική αμαξοστοιχία; φαίνεται πως ενώνουν τις πολιτικές δυνάμεις του προοδευτικού τόξου εναντίον του.	SUBJ
Οι δομές υγείας των δύο νησιών ενισχύονται με προσωπικό, ενώ διεξάγονται και έλεγχοι στατικότητας σε κτίρια.	OBJ
Ενημέρωση για τα γεωλογικά φαινόμενα στην Σαντορίνη έκανε ο καθηγητής Γεωφυσικής του ΑΠΘ Κωνσταντίνος Παπαζάχος, στο τέλος της σύσκεψης του πρωθυπουργού, Κυριάκου Μητσοτάκη, με τους φορείς.	OBJ
Κάποια έχουν την αμερικανική εθνικότητα.	OBJ
Οι ομάδες αυτές έχουν πλέον άνευ προηγουμένου πρόσβαση στο σύστημα πληρωμών, την οποία είχαν μέχρι τώρα αποκλειστικά μη κομματικοί υψηλόβαθμοι δημόσιοι αξιωματούχοι.	OBJ
Ο Ντάριν Λαχούντ χαρακτήρισε παράλληλα την DeepSeek «επιχείρηση που συνδέεται με το ΚΚΚ» και δήλωσε βέβαιος ότι δεν θα πρέπει «υπό κανένα πρόσχημα» να λάβει άδεια για «να αποκτήσει ευαίσθητα δεδομένα της κυβέρνησης» ή των χρηστών.	OBJ
Στο Ελ Σαλβαδόρ λειτουργεί η μεγαλύτερη φυλακή στη Λατινική Αμερική	OBJ
? Σχεδόν οι μισοί από τους ερωτηθέντες (45%) θεωρούν ότι η Τεχνητή Νοημοσύνη δεν είναι στην ημερήσια διάταξη του Διοικητικού Συμβουλίου.	OBJ
«Είμαστε σε καλή πορεία για το απίθανο αυτό σενάριο, για το σενάριο που συγκεντρώνει ελάχιστες πιθανότητες εκδήλωσης με το οποίο αναπτύχθηκε όλη η επιχειρησιακή δραστηριότητα στο νησί».	OBJ
Η Τουρκία συνεχίζει την πρόκληση βορείως της Κρήτης, έχοντας την κορβέτα κλάσης Burak στα 10 ναυτικά μίλια από τα υπό ιταλική σημαία «Ievoli Relume» και «NG Worker» που συνεχίζουν κανονικά τις εργασίες τους.	OBJ
«Σας ευχαριστούμε για τις υπηρεσίες σας»; κατέληγε.	OBJ
Πάντως η Τουρκία συνεχίζει, παρά το καλό κλίμα στη συνάντηση Γεραπετρίτη – Φιντάν στην Ντόχα, να θέτει ζητήματα που αν μη τι άλλο αμφισβητούν κυριαρχικά δικαιώματα και συνθήκες.	SUBJ
Σε αργία τίθεται από την Παρασκευή όλο το προσωπικό της υπηρεσίας Διεθνούς Ανάπτυξης (USAID) των ΗΠΑ σε μία κίνηση σοκ από την αμερικανική κυβέρνηση που ανακοίνωσε μέσω του Έλον Μασκ ότι θα κλείσει τον οργανισμό με προϋπολογισμό 40 δισ. δολάρια που προορίζονται για την παροχή ανθρωπιστικής βοήθειας και ανάπτυξης σε όλο τον κόσμο.	OBJ
Δεν σημαίνει αυτό ότι θα γίνει έκρηξη, αλλά ότι το ηφαιστειακό σύμπλεγμα της Σαντορίνης μπορεί να μεγαλώνει και με άλλους κρατήρες, είπε ο Κωνσταντίνος Συνολάκης καθηγητής στο Πανεπιστήμιο της Νότιας Καλιφόρνιας και μέλος της Ακαδημίας Αθηνών, μιλώντας στο ΕΡΤΝews.	OBJ
«Τα σενάρια που έχουμε “τρέξει” δεν δείχνουν κάτι το σημαντικό»; τόνισε και συμπλήρωσε ότι «τίποτε δεν μπορεί να αποκλείσει τη φύση και εκπλήξεις».	OBJ
Γίνε μέλος στο κανάλι μας στο Viber	OBJ
Πηγή: ΑΠΕ  ΜΠΕ	OBJ
Επιχείρηση σε 30 χώρες	OBJ
Ελπίζω τα πράγματα να πηγαίνουν προς το καλύτερο».	OBJ
Επίσης; αναμένονται ένας παιδίατρος και ένας ορθοπεδικός γιατρός στο νησί.	OBJ
Ο Τραμπ ζήτησε ήδη από τις 20 Ιανουαρίου, αμέσως μετά την ορκωμοσία του στην προεδρία των ΗΠΑ, να παγώσει σχεδόν το σύνολο της ανθρωπιστικής βοήθειας που παρέχει η Ουάσινγκτον σε όλο τον κόσμο μέσω της USAID, στο πλαίσιο της πολιτικής του «η Αμερική πρώτα», προκαλώντας σοκ στις ανθρωπιστικές οργανώσεις.	OBJ
Η έρευνα κατέδειξε ότι πολλές επιχειρήσεις εξακολουθούν να αμφιταλαντεύονται για το πώς να υιοθετήσουν και να εφαρμόσουν την Τεχνητή Νοημοσύνη.	OBJ
Δεν υπάρχουν νικητές	OBJ
Το τουρκολιβυκό μνημόνιο δεν είναι αόριστη σύλληψη στο μυαλό μας που απομονώνει τα νησιά μας από την ενδοχώρα.	SUBJ
Τέλος σημείωσε:	OBJ
Όπως τόνισε, μιλώντας στο ΕΡΤΝews ο Eυθύμιος Λέκκας ερωτηθείς για το ποιος είναι ο μέγιστος πιθανός σεισμός που μπορεί να δώσει η περιοχή απάντησε ότι είναι 6 Ρίχτερ και κάτω.	OBJ
Η σημασία του ΑΙ στα Διοικητικά Συμβούλια	OBJ
Όπως είπε ο κ. Παπαζάχος η ακολουθία συνεχίζει σε αυτές τις τέσσερις μέρες με την ίδια ένταση ωστόσο είναι «πιο αισιόδοξοι» καθώς βλέπουν «το κομμάτι του ρήγματος, το οποίο έχει πλέον πιο σαφή χαρακτηριστικά μετά την πύκνωση του δικτύου, να αρχίζει να “γεμίζει”, δηλαδή να απομακρύνονται οι πιθανότητες όλο και περισσότερο, να γίνεται όλο και πιο απίθανο το σενάριο μιας ισχυρότερης δόνησης».	OBJ
Με βάση τη νομοθεσία για την ίδρυσή της, την οποία ψήφισε το Κογκρέσο το 1961, η USAID είναι ανεξάρτητος οργανισμός.	OBJ
«Έχουμε τρία διαφορετικά πράγματα.	OBJ
Εν τω μεταξύ, καθώς η τεχνολογία εξελίσσεται, όλο και περισσότεροι εργαζόμενοι αποκτούν πρόσβαση σε εργαλεία AI, είτε είναι εγκεκριμένα από τον οργανισμό τους είτε όχι, γεγονός που μπορεί να δημιουργήσει πραγματικούς κινδύνους για τους οργανισμούς.	OBJ
Η νύχτα κύλησε ήρεμα ωστόσο λίγο μετά τις 9:00 σημειώθηκε σεισμός 4,8 Ριχτερ, μεταξύ Σαντορίνης και Αμοργού, που έγινε ιδιαίτερα αισθητός και στα γύρω νησιά.	OBJ
Παρά τις αυξημένες επενδύσεις και την καινοτομία στην Τεχνητή Νοημοσύνη, δεν αποτελεί ακόμα προτεραιότητα στην ατζέντα των Διοικητικών Συμβουλίων, όπως επισημάνθηκε και από πρόσφατη έρευνα της Deloitte.	OBJ
Τα συνολικά έσοδα από την εγκληματική δραστηριότητα υπερέβησαν τα 6,5 εκατομμύρια ευρώ.	OBJ
Οι ΗΠΑ εξετάζουν πρωτοφανές σχέδιο για αποστολή κρατουμένων - ακόμα και Αμερικανών - στις φυλακές «φρούρια» του Ελ Σαλβαδόρ	SUBJ
Επικίνδυνα για την υγεία	SUBJ
Σύμφωνα με την έρευνα της Deloitte, η χρήση των συστημάτων Αgentic AI (Αυτόνομων Συστημάτων Τεχνητής Νοημοσύνης που δρουν με ελάχιστη ή καμία ανθρώπινη παρέμβαση) αυξάνεται	OBJ
Ο Ντόναλντ Τραμπ έχει ανακοινώσει πως εννοεί να τερματίσει το δικαίωμα του εδάφους (την αυτόματη απόκτηση της υπηκοότητας οποιουδήποτε παιδιού γεννιέται στις ΗΠΑ) και συνεχίζει την εκστρατεία μαζικών απελάσεων παράτυπων μεταναστών.	OBJ
Στη διαδικασία αυτή εμπλέκονται όχι μόνο οι Διευθύνοντες Σύμβουλοι και οι υπεύθυνοι τεχνολογίας, αλλά και άλλα C-suite στελέχη που πρέπει να αξιολογούν τους κινδύνους και τις ευκαιρίες που προκύπτουν από το AI.	OBJ
«Κινούμαστε πάντα με στοιχεία, δεν κινούμαστε με υποθέσεις.	OBJ
Οι κατασχέσεις αφορούν 426.016 πακέτα παράνομων φαρμάκων, 4.111 κιλά σκόνης και πρώτων υλών, 108 λίτρα ενεργού συστατικού, 174.968 φιαλίδια και αμπούλες και περισσότερα από 4,5 εκατ. δισκία και χάπια.	OBJ
Μόνο το 3% των ερωτηθέντων στην έρευνα της Deloitte, απάντησε ότι η επιχείρησή τους είναι πραγματικά έτοιμη να αναπτύξει το ΑΙ, ενώ το 41% εκτιμά ότι δεν είναι (ή θεωρεί το αντίθετο)	OBJ
Από ελληνικής πλευράς η φρεγάτα «Σπέτσες» και σκάφος του Λιμενικού συνεχίζουν να βρίσκονται κοντά στα δύο ερευνητικά, διατηρώντας ετοιμότητα για κάθε πιθανή κίνηση από την πλευρά της τουρκικής μονάδας.	OBJ
Εχουμε λοιπόν μια διατυπωμένη απειλή από μια χώρα 10 φορές μεγαλύτερη από εμάς».	OBJ
Κάποιοι εργαζόμενοι «αρμόδιοι για τη λειτουργία κρίσιμων αποστολών (… ) και ειδικών προγραμμάτων» εξαιρούνται από την απόφαση.	OBJ
Ο κ. Ρούμπιο αναφέρθηκε ιδίως σε μέλη συμμοριών από τη Λατινική Αμερική; όπως για παράδειγμα η Μάρα Σαλβατρούτσα (MS-13) από το Ελ Σαλβαδόρ; ή η Tren de Aragua από τη Βενεζουέλα; που δρουν στις ΗΠΑ.	OBJ
Εκτός από τους ενδεχόμενους δασμούς στην Κολομβία από τον Πρόεδρο των ΗΠΑ Ντόναλντ Τραμπ, οι τιμές του καφέ έχουν επίσης επηρεαστεί από την κακή συγκομιδή στη Βραζιλία, η οποία είναι ένας από τους κύριους παραγωγούς.	OBJ
«Αναξιόπιστος ο Πρωθυπουργός»	SUBJ
Ωστόσο, δεν έχει θίξει μέχρι τώρα το καθεστώς των 232.000 Σαλβαδοριανών που θα μπορούσαν δυνητικά να απελαθούν επίσης.	OBJ
Η κα. Κατερίνα Γλαβά, Partner, Engineering, AI & Data, Financial Services Industry Leader στην Deloitte Ελλάδος δήλωσε σχετικά:	OBJ
Επίσης, περιγράφοντας πως εξελίσσεται εκ μέρους της κυβέρνησης η επιχείρηση συγκάλυψης, περιέγραψε ότι «το ΠαΣοΚ πήρε τα στοιχεία από το πόρισμα της Ευρωπαϊκής Εισαγγελίας πέρυσι, -χωρίς να βάλουμε ούτε λέξη παραπάνω-, και βάσει αυτού προτείναμε προανακριτική για τις ποινικές ευθύνες του κ. Καραμανλή που περιγράφονται με καθαρό τρόπο.	OBJ
Η ίδια εκτιμά επίσης ότι ο παραμερισμός εξειδικευμένου προσωπικού «αυξάνει τον κίνδυνο να μην μπορέσει η χώρα να αποπληρώσει το χρέος της, κάτι που θα μπορούσε να προκαλέσει παγκόσμια χρηματοοικονομική κρίση».	OBJ
Χαρίζει ζωή ο 3χρονος Άγγελος – Η καρδιά του θα σώσει ένα παιδί από τη Γερμανία  UPD 88	OBJ
Βουτιά μετοχής ΑΜD μετά τα αποτελέσματα για τα data centers	OBJ
Ακολούθησε μας στο Twitter	OBJ
Η USAID είναι ο μεγαλύτερος δωρητής ανθρωπιστικής βοήθειας παγκοσμίως.	OBJ
Έτυχε προχθές το βράδυ να γίνουν όλοι μεταξύ 03:00 και 05:30 τα ξημερώματα.	OBJ
Εκτοτε παραμένει σε «άνθηση», παρά τις συντονισμένες ενέργειες των Αρχών πανευρωπαϊκά, κυρίως λόγω της ευκολίας διάθεσής τους μέσω του Διαδικτύου.	SUBJ
Η Τουρκία προσπαθεί να το επιβάλει επί του πεδίου.	OBJ
«Η διαφθορά και η σπατάλη εξαλείφονται σε πραγματικό χρόνο», υποστήριξε ο πλουσιότερος άνθρωπος του κόσμου, στον οποίο ο Ντόναλντ Τραμπ ανέθεσε να διευθύνει μια επιτροπή «κυβερνητικής αποδοτικότητας» (DOGE).	OBJ
Έχει έναν τρόπο η ακολουθία, έχει ένα μηχανισμό μάλλον, που οφείλεται σε ρευστά και δίνει μεγάλες εξάρσεις σεισμών, μαζεμένων σε κάποιες ώρες.	OBJ
● Μόλις το 2% πιστεύει πως τα Διοικητικά τους Συμβούλια κατέχουν σημαντική γνώση και εμπειρία γύρω από το ΑΙ.	OBJ
«Παρά το γεγονός ότι η ελληνική νομοθεσία μέχρι σήμερα απαγορεύει τη διακίνηση φαρμάκων μέσω Διαδικτύου, πολλοί καταφεύγουν σε ιστοσελίδες του εξωτερικού αλλά και του εσωτερικού, αφού προβάλλονται στην ελληνική γλώσσα, αμφιβόλου προελεύσεως, που διαφημίζουν τη γρήγορη αγορά φαρμάκων χωρίς συνταγή γιατρού», επισημαίνει ο Εθνικός Οργανισμός Φαρμάκων σε σχετικό ερώτημα της «Κ».	SUBJ
– Σε ένα από τα δύο σημεία να υπάρχει ενεργός σύνδεσμος	OBJ
Κάθε μέρα, νομίζω, πηγαίνουμε ελαφρά προς το καλύτερο, αλλά δεν θα είναι τόσο γρήγορη η απεμπλοκή μας.	SUBJ
Έτσι θα πορευτούμε και το επόμενο χρονικό διάστημα.	OBJ
Κ. Συνολάκης στο EΡTNews:	OBJ
«Του είμαστε βαθιά ευγνώμονες.	OBJ
Νέα Καμένη: Τοποθέτηση νέου σεισμογράφου	OBJ
Ειδικότερα, το Deloitte Global Boardroom Program πραγματοποίησε έρευνα σε περίπου 500 μέλη Διοικητικών Συμβουλίων και σε στελέχη C-suite σε 57 χώρες, εξετάζοντας τόσο την εφαρμογή της Τεχνητής Νοημοσύνης στην εταιρική διακυβέρνηση, όσο και το αν η υιοθέτησή της από τα Διοικητικά Συμβούλια αποτελεί προτεραιότητα.	OBJ
● Το 41% εκτιμά ότι η εταιρεία τους δεν είναι έτοιμη για την εφαρμογή του ΑΙ και τις προκλήσεις που φέρνει.	OBJ
Το Πεκίνο αντεπιτίθεται με δασμούς 15% σε αμερικανικούς υδρογονάνθρακες	OBJ
Το 2024 η υπηρεσία προσέφερε το 42% του συνόλου της ανθρωπιστικής βοήθειας που καταγράφεται από τον ΟΗΕ.	OBJ
Περισσότερες συνεργασίες, μεγαλύτερη ενότητα, υπογράμμιση της σημασία της εταιρικής σχέσης ΗΠΑ – ΕΕ, αλλά και προειδοποίηση για ισχυρή απάντηση σε περίπτωση επιβολής δασμών από τις ΗΠΑ ήταν το μήνυμα από τις δηλώσεις των ηγετών των «27».	SUBJ
Η Κολομβία θα μπορούσε να επηρεαστεί σημαντικά από τους δασμούς των ΗΠΑ; καθώς η τελευταία είναι ο μεγαλύτερος εμπορικός εταίρος της.	OBJ
Ποιος είναι αρμόδιος για την εφαρμογή του ΑΙ στην εταιρική διακυβέρνηση;	OBJ
Β. Καραστάθης:	OBJ
Όμως, πιστεύω ότι τις επόμενες μέρες θα παραμείνουμε σε σχετικά συντηρητικά σενάρια.	SUBJ
Ορισμένα Διοικητικά Συμβούλια στρέφονται σε εξωτερικούς ή εσωτερικούς συμβούλους για να ενισχύσουν τη γνώση τους στο συγκεκριμένο τομέα.	OBJ
· Το 26% δηλώνει ότι συνεργάζεται με τον Επικεφαλής Οικονομικών Υπηρεσιών (CFO).	OBJ
Δικαιώματα καταναλωτών απέναντι στους servicers	OBJ
Ο Πρωθυπουργός Κυριάκος Μητσοτάκης επισκέφθηκε το πρωί τη Σαντορίνη, όπου ενημερώθηκε για τα μέτρα πολιτικής προστασίας που έχουν τεθεί σε εφαρμογή από τον κρατικό μηχανισμό, σε συνεργασία με την επιστημονική κοινότητα και την τοπική αυτοδιοίκηση, και συνομίλησε με τοπικούς φορείς σχετικά με τις ανάγκες και τη στήριξη του νησιού.	OBJ
α) ανίχνευση απαγορευμένων ουσιών με αναβολική δράση ή αντιορεξιογόνο δράση; οι οποίες εξ ορισμού θέτουν σε σοβαρό κίνδυνο την υγεία του χρήστη; β) ανίχνευση φαρμακευτικών δραστικών ουσιών; π.χ. σιλντεναφίλη για την αντιμετώπιση της στυτικής δυσλειτουργίας».	OBJ
Η αμοιβή θα είναι σχετικά χαμηλή για τις ΗΠΑ αλλά σημαντική για εμάς	OBJ
Ήδη δεκάδες υψηλόβαθμα στελέχη της USAID έχουν τεθεί σε αργία, ενώ έχει αποκλειστεί στους εργαζόμενους η πρόσβαση στην έδρα της υπηρεσίας στην Ουάσιγκτον.	OBJ
Ο Τραμπ απείλησε πρόσφατα να επιβάλει γενικό δασμό 25% σε όλες τις εισαγωγές της Κολομβίας εν μέσω κλιμάκωσης της έντασης μεταξύ των δύο χωρών.	OBJ
Γι’ αυτό και οι εθνικές επιτροπές, όπως πολύ σωστά είπατε, βγάζουν μία μέση άποψη η οποία είναι ψύχραιμη και ώριμη και συμφωνώ απόλυτα μαζί σας ότι δεν πρέπει ο κόσμος να ακούει τις φήμες που αναπτύσσονται», υπογράμμισε.	OBJ
Με τη συμμετοχή κορυφαίων ηγετικών στελεχών από Google και OpenAI; στόχος παραμένει η παγκόσμια συναίνεση για την τεχνητή νοημοσύνη	OBJ
Καθώς οι επιχειρήσεις εξετάζουν αποτελεσματικούς τρόπους υιοθέτησης του ΑΙ, τα Διοικητικά Συμβούλια θα πρέπει να εφαρμόζουν προστατευτικά μέτρα για να μετριάσουν τους κινδύνους από τη χρήση μη εγκεκριμένων εργαλείων Τεχνητής Νοημοσύνης.	OBJ
Σύμφωνα με τον κ. Ρούμπιο, η κυβέρνηση του Ελ Σαλβαδόρ δηλώνει έτοιμη να υποδεχθεί τους υπηκόους της, όπως και άλλες χώρες της Λατινικής Αμερικής.	OBJ
Η Διεύθυνση Αντιμετώπισης Οργανωμένου Εγκλήματος χειρίσθηκε 9 υποθέσεις; που αφορούσαν ισάριθμες εγκληματικές οργανώσεις με δράση εντός και εκτός Ελλάδας.	OBJ
Κοινωνικά δίκτυα; ηλεκτρονικά καταστήματα ή ψηφιακοί χώροι αγοραπωλησιών που ευδοκιμούν στο σκοτεινό αλλά και στο νόμιμο Διαδίκτυο παρέχουν την ιδανική κάλυψη για την αθρόα προώθηση πλαστών φαρμακευτικών σκευασμάτων.	SUBJ
Σύμφωνα με τον κ. Ρούμπιο, η πρόταση αυτή άνευ προηγουμένου συμπεριλαμβάνει «αμερικανούς υπηκόους και ανθρώπους με άδεια παραμονής» στις ΗΠΑ.	OBJ
Αυτές οι μεταβολές είναι πάντα στα πλαίσια της φυσικής εξέλιξης.	SUBJ
Δεν είναι διόλου τυχαία η αναφορά του υπουργού Εθνικής Αμυνας Νίκου Δένδια σε κομματική εκδήλωση στα Ιωάννινα:	SUBJ
Είναι απόφαση της τουρκικής Εθνοσυνέλευσης.	OBJ
Ομοίως, σε περίπτωση κλιμάκωσης εμπορικού πολέμου μεταξύ των δύο χωρών, οι ΗΠΑ θα μπορούσαν επίσης να επηρεαστούν από τις υψηλότερες τιμές του καφέ.	OBJ
Σε μια ξεχωριστή εξέλιξη, η Ινδία προειδοποίησε επίσης ότι οι εξαγωγές καφέ της το 2025 είναι πιθανό να είναι περίπου 10% χαμηλότερες λόγω των προβλέψεων για ένα ζεστό καλοκαίρι με ξηρασία.	OBJ
Είμαστε όλο και πιο αισιόδοξοι γιατί βλέπουμε το κομμάτι του ρήγματος, το οποίο έχει πλέον πιο σαφή χαρακτηριστικά μετά την πύκνωση του δικτύου, να αρχίζει να γεμίζει, δηλαδή να απομακρύνονται οι πιθανότητες όλο και περισσότερο, να γίνεται όλο και πιο απίθανο το σενάριο μιας ισχυρότερης δόνησης», ανέφερε χαρακτηριστικά ο κ. Παπαζάχος.	SUBJ
Ο 40άρης ηλεκτρολόγος που δημιούργησε την DeepSeek «έβαλε τα γυαλιά» στο περιβόητο ChatGPT και έσπειρε τον πανικό στη Wall Street	SUBJ
Οι επιστήμονες έχουν τοποθετηθεί σχετικά με το χειρότερο σενάριο και ευχόμαστε ότι αυτή η ακολουθία θα εκτονωθεί χωρίς να δώσει κάποιο μεγαλύτερο σεισμό.	SUBJ
Με την προσφυγή ζητείται από έναν ομοσπονδιακό δικαστή να κηρύξει παράνομο το γεγονός ότι ο Μασκ ή άλλα μέλη της DOGE μπορούν να λαμβάνουν προσωπικές πληροφορίες για τους φορολογουμένους.	OBJ
Μίλησα με τον πρόεδρο (Ντόναλντ) Τραμπ», πρόσθεσε.	OBJ
Οι συνεχιζόμενες εκδόσεις αποτελούν μέρος μιας ευρύτερης στρατηγικής για την Google να επενδύει σε μεγάλο βαθμό σε «πράκτορες τεχνητής νοημοσύνης»	OBJ
Το ηφαιστειακό σύμπλεγμα της Σαντορίνης μπορεί να μεγαλώνει	OBJ
Κάνε εγγραφή στο κανάλι μας στο Youtube	OBJ
Την Τετάρτη (5/2); η αμερικανική εταιρεία κυβερνοασφάλειας Feroot Security ανακοίνωσε ότι το μοντέλο τεχνητής νοημοσύνης της DeepSeek περιέχει γραμμές κώδικα που καθιστούν δυνατή τη μετάδοση προσωπικών δεδομένων στην China Mobile; κινεζική δημόσια επιχείρηση τηλεπικοινωνιών.	OBJ
Υψηλότερη κατάρτιση για τη βελτίωση των γνώσεων στην Τεχνητή Νοημοσύνη	OBJ
Μάλιστα την ιδέα αυτή εξήρε ο αμερικανός υπουργός Εξωτερικών Μάρκο Ρούμπιο, που είχε συνάντηση μαζί του στο Σαν Σαλβαδόρ.	OBJ
Generative AI: Έρευνα της Deloitte για το μέλλον της τεχνητής νοημοσύνης	OBJ
Η ΑΙ στρατηγική της AustriaCard Holdings εμπλουτίζεται και αξιοποιεί το σύνολο μοντέλων παραγωγικής τεχνητής νοημοσύνης	OBJ
«Ανησυχώ για το γεγονός ότι με ένα από τα πρώτα μέτρα σας ως υπουργού, φαίνεται να δώσατε το έλεγχο ενός πολύ ευαίσθητου συστήματος υπεύθυνου για τα προσωπικά δεδομένα εκατομμυρίων Αμερικανών -και ένα πυλώνα κλειδί της κυβέρνησής μας- σε έναν δισεκατομμυριούχο, ο οποίος δεν έχει εκλεγεί, και σε απροσδιόριστο αριθμό τοποτηρητών του που δεν έχουν τα απαιτούμενα προσόντα», γράφει στην επιστολή.	SUBJ
«Το Κομμουνιστικό Κόμμα Κίνας (ΚΚΚ) έχει καταστήσει σαφές ότι θα χρησιμοποιήσει οποιοδήποτε εργαλείο έχει στη διάθεσή του για να υπονομεύσει την εθνική ασφάλειά μας; για να διαδώσει επικίνδυνη παραπληροφόρηση και να συλλέξει δεδομένα Αμερικανών»; υποστηρίζει ο Γκοτχάιμερ σε ανακοίνωσή του.	OBJ
«Καμιά άλλη χώρα δεν είχε κάνει ποτέ τέτοια φιλική προσφορά», σημείωσε ο νέος επικεφαλής της αμερικανικής διπλωματίας μετά την τρίωρη συνάντησή του με τον κ. Μπουκέλε.	OBJ
Σε «άνθηση» το παρεμπόριο μετά την πανδημία	SUBJ
Ενόσω «το Παρίσι παραμένει σταθερό στη θέση του ότι τα χρήματα των ευρωπαίων φορολογουμένων πρέπει να δαπανώνται σε στρατιωτικά συστήματα που σχεδιάζονται και κατασκευάζονται στην Ευρώπη, πολλές άλλες χώρες προειδοποιούν ότι ο αποκλεισμός των αμερικανικών κατασκευαστριών όπλων από τις επιδοτήσεις της ΕΕ θα εξοργίσει τον πρόεδρο των ΗΠΑ, υποστήριξαν αρκετοί διπλωμάτες», γράφει το Politico, σκιαγραφώντας τη διασύνδεση και της ευρωπαϊκής άμυνας με τους επαπειλούμενους δασμούς Τραμπ.	SUBJ
Ο Δημοκρατικός γερουσιαστής Τζος Γκοτχάιμερ του Νιου Τζέρσι παρουσίασε την πρόταση νόμου μαζί με τον Ρεπουμπλικανό συνάδελφό του του Ιλινόι Ντάριν Λαχούντ, επιχειρηματολογώντας ότι πρόκειται για «ανησυχητική απειλή για την εθνική ασφάλεια των ΗΠΑ».	OBJ
Πρωταγωνιστής ωστόσο  αν και ουχί παρών  ήταν ο Ντόναλντ Τραμπ.	SUBJ
 Αναφέρεται ως πηγή το ertnews.gr στο σημείο όπου γίνεται η αναφορά.	OBJ
Ο πρόεδρος του Ελ Σαλβαδόρ Ναγίμπ Μπουκέλε εισηγήθηκε χθες Δευτέρα η χώρα του να υποδεχτεί κρατούμενους στις ΗΠΑ έναντι χρηματικού αντιτίμου.	OBJ
Προστασία κατοικίας  αγροτικής περιουσίας	OBJ
Υπό τη «μέγγενη» πολλαπλασιαζόμενων γεωπολιτικών προκλήσεων στην εποχή Τραμπ 2.0, αλλά και των μεταξύ τους διαφωνιών, οι ηγέτες των «27» έθεσαν χθες επί τάπητος το μέλλον της ευρωπαϊκής άμυνας και ασφάλειας στην άτυπη μεν, πλην πρώτη με αποκλειστικά αυτό το θέμα σύνοδο κορυφής της ΕΕ, στις Βρυξέλλες.	SUBJ
Ο Μασκ ελέγχει πλέον το σύστημα πληρωμών του αμερικανικού υπ. Οικονομικών - Σε θέσεις κλειδιά 20άρηδες συνεργάτες του	OBJ
· Το 69% αναφέρει ότι τα Διοικητικά Συμβούλια συνεργάζονται με τον Επικεφαλής Τεχνολογίας (CTO) ή τον Επικεφαλής Πληροφοριών (CIO) σχετικά με την Τεχνητή Νοημοσύνη.	OBJ
Δεν έχει αρμοδιότητα για τέτοιες αποφάσεις	OBJ
Η παρέμβαση Κατρίνη για τα Τέμπη	OBJ
Δημιουργούνται ψευδαισθήσεις καμιά φορά ότι η ακολουθία ηρεμεί.	OBJ
Ο κ. Μπουκέλε επανεξελέγη στην προεδρία του Ελ Σαλβαδόρ αφού παρέκαμψε τη συνταγματική απαγόρευση των συναπτών θητειών στο κορυφαίο αξίωμα με το 80% των ψήφων πέρυσι, κυρίως χάρη στον «πόλεμο» που κήρυξε στις συμμορίες.	OBJ
Πώς αποσυνδέει, λοιπόν, ο υπουργός Δικαιοσύνης την υλοποίηση του έργου της τηλεδιοίκησης από την τραγωδία των Τεμπών;»	OBJ
«Φουντώνει» ο εμπορικός πόλεμος ΗΠΑ-Κίνας: Το Πεκίνο αντεπιτίθεται με δασμούς 15% σε αμερικανικούς υδρογονάνθρακες	OBJ
Σχετικές ειδήσεις:	OBJ
Τα συμβόλαια μελλοντικής εκπλήρωσης του καφέ Arabica έχουν αυξηθεί κατά περίπου 90% σε ετήσια βάση.	OBJ
Περίπου το 8% του καφέ που φθάνει στις ΗΠΑ προέρχεται από το Βιετνάμ; ενώ το 7% προέρχεται από την Ονδούρα	OBJ
«Οι σεισμοί τη νύχτα; ήταν ελάχιστοι με την έννοια ότι ο κόσμος κοιμήθηκε ήσυχα.	OBJ
Έχει δραστηριοποιηθεί όλος ο χώρος δίπλα από το ρήγμα της Ανύδρου	OBJ
Επίσης; οι ληξιπρόθεσμες βεβαιωμένες οφειλές ρυθμίζονται στις 120 δόσεις; με τον οφειλέτη να απαλλάσσεται από το 30% της οφειλής; εφόσον είναι συνεπής στην αποπληρωμή της ρύθμισης.	OBJ
Η έξαρση του παραεμπορίου ψευδεπίγραφων, μη εγκεκριμένων ή παράνομων σκευασμάτων έχει τις ρίζες της στις απαρχές της πανδημίας της COVID-19, οπότε εγκληματικά δίκτυα εκμεταλλεύτηκαν τις ελλείψεις σε ιατρικό και ατομικό προστατευτικό εξοπλισμό, αλλά και τον ανθρώπινο φόβο, φτάνοντας να διαθέτουν στην αγορά μέχρι και ψευδεπίγραφα εμβόλια.	SUBJ
Οι σεισμοί τη νύχτα ήταν ελάχιστοι αλλά δεν πρόκειται ούτε για αιφνίδια, ούτε για συστηματική αραίωση	OBJ
«Περιμένουμε να πέσουν τα Μποφόρ για να σηκώσουμε τους υποθαλάσσιους τομογράφους στην καλντέρα της Σαντορίνης», είπε στο ΕΡΤΝews η καθηγήτρια Γεωλογικής Ωκεανογραφίας, Εύη Νομικού η οποία και διέψευσε ότι τα επιστημονικά δεδομένα δείχνουν ότι υπάρχει κίνδυνος έκρηξης του υποθαλάσσιου ηφαιστείου της Σαντορίνης.	OBJ
Ο 40χρονος Ασιάτης που αλλάζει τον κόσμο της ΑΙ	OBJ
Η συνέντευξη του Κυριάκου Μητσοτάκη στον τηλεοπτικό σταθμό ALPHA προκάλεσε θόρυβο και συνοδεύτηκε από κύμα οργής κι αγανάκτησης στα μέσα κοινωνικής δικτύωσης.	OBJ
Πρόταση δυσπιστίας στη ΝΔ	OBJ
 Σε ένα από τα δύο σημεία να υπάρχει ενεργός σύνδεσμος	OBJ
? Σχεδόν οι μισοί (46%) δηλώνουν ότι δεν είναι ικανοποιημένοι σχετικά με τον χρόνο που αφιερώνουν τα Διοικητικά Συμβούλια στην εφαρμογή εργαλείων Τεχνητής Νοημοσύνης.	OBJ
Ο Νίκος Ανδρουλάκης σε χθεσινή τηλεοπτική του συνέντευξη στον δημοσιογράφο Νίκο Παναγιωτόπουλο έκανε λόγο για ρεσιτάλ αναξιοπιστίας και ψέματος από την κυβέρνηση και επανέλαβε τη θέση του ΠαΣοΚ για κατάθεση πρότασης δυσπιστίας, μόλις έρθουν στο φως τα πορίσματα από το Εθνικό Μετσόβιο Πολυτεχνείο αλλά κι εκείνο της Επιτροπής Διερεύνησης Ατυχημάτων.	SUBJ
Η τελευταία επιχείρηση «SHIELD» της EUROPOL, που αφορά 30 χώρες, είχε ως αποτέλεσμα την απόσυρση από την αγορά παράνομων σκευασμάτων συνολικής αξίας 11,1 εκατ. ευρώ.	OBJ
Αυτό, που θέλουμε εμείς να δούμε, είναι μια συστηματική αραίωση, δηλαδή σε μεγαλύτερα χρονικά διαστήματα, ώστε να είναι πιο αξιόπιστοι οι μέσοι όροι.	SUBJ
· Οι επιτροπές που συνήθως ασχολούνται με την εφαρμογή του ΑΙ είναι είτε η Επιτροπή Κινδύνου και Κανονιστικών Ρυθμίσεων (25%) είτε η Επιτροπή Ελέγχου (22%).	OBJ
Συνεργάτες του Έλον Μασκ πήραν τον έλεγχο του συστήματος πληρωμών του αμερικανικού υπουργείου Οικονομικών, αρμόδιου για τη διανομή ομοσπονδιακών κεφαλαίων τρισεκατομμυρίων δολαρίων, ένα μέτρο που καταγγέλθηκε από δημοκρατικούς αιρετούς αξιωματούχους ως «εξαιρετικά επικίνδυνο» και έχει αποτελέσει αντικείμενο προσφυγής στη δικαιοσύνη.	OBJ
