sentence	prediction
Pokonała go tęczowa flaga	OBJ
Zanim rozważymy podróż podczas zwolnienia lekarskiego od psychiatry, należy najpierw przyjrzeć się oznaczeniem na zwolnieniu. 	OBJ
"""Patriota"", widząc kolorową flagę powiewającą na wietrze, za punkt honoru wziął sobie zerwanie jej i zabranie. "	SUBJ
Na miejscu drugim znalazło się zaś Prawo i Sprawiedliwość, które liczyć może na 29 proc. głosów. 	OBJ
Nie ma żadnych szans na 10 tys.	SUBJ
Wbrew propagandowemu oszustwu można było uniknąć brexitu, ale kanclerz Merkel i Tusk, jako przewodniczący Rady Europejskiej, a potem lider Europejskiej Partii Ludowej, wykonali ciężką pracę, aby... -	SUBJ
"Jeśli na dokumencie widnieje cyfra ""2"", która oznacza ""chory może chodzić"" nie ma przeszkód w podróżowaniu poza miejsce zamieszkania. "	OBJ
Jak Berlin ogra Tuska	OBJ
Jaka wysokość świadczeń dla imigrantów Polsce?	OBJ
Młody mężczyzna natknął się na nią, gdy wracał z centrum miasta po zakończonym przemarszu. 	OBJ
Całe zdarzenie zarejestrowała kamera monitoringu.	OBJ
Więcej o tym, z czym wiąże się zwolnienie lekarskie od psychiatry, pisaliśmy w tym artykule. 	OBJ
Na pokładzie dumnego brytyjskiego pancernika nazywającego się „Książę Walii”, 12 sierpnia 1941 roku, Franklin D. Roosevelt, 32. prezydent Stanów Zjednoczonych Ameryki, oraz Winston Churchill, premier...	OBJ
Wpadka po powrocie z Marszu Niepodległości.	OBJ
Mężczyzna chciał zerwać tęczową flagę.  2	OBJ
Jak już wspomniano, była to prognoza bez podstawy prawnej. 	OBJ
– Na spadek liczby prób nielegalnego przedostania się z Białorusi do Polski znaczący wpływ ma powstanie bariery fizycznej na granicy i uruchomienie już ponad 100 km bariery elektronicznej, oraz nasza zdecydowana postawa w pierwszej fazie presji migracyjnej – mówi Anna Michalska, rzeczniczka KG SG. 	OBJ
Alternatywa dla Niemiec (AfD) mówi o niemieckich zbrodniach z II wojny światowej tak samo jak niemiecki mainstream.	OBJ
Imigrant poza ośrodkiem może liczyć na ekwiwalent w wysokości do 25 zł na dzień (§ 6 rozporządzenia).	OBJ
"""Plan sprytny, wykonawca jeszcze bardziej"", ""Jaki bohater"", ""Instant karma"", ""Geniusz zbrodni"" — komentują internauci. "	OBJ
Młody mężczyzna rzucił się na tęczową flagę wiszącą przed jedną z warszawskich restauracji, ale potknął się i upadł, gubiąc telefon. 	OBJ
Wstyd na całą Polskę	SUBJ
Uczestnicy wysłuchania publicznego w Sejmie w większości bardzo negatywnie ocenili projekt nowelizacji ustawy o udzielaniu cudzoziemcom ochrony na terytorium Rzeczypospolitej Polski.	OBJ
- Więcej aktualnych wiadomości znajdziesz na stronie głównej Onetu	OBJ
W związku z trudnościami z mówieniem poprosił swojego asystenta o odczytanie przygotowanego przez niego przesłania.	OBJ
W pobliżu jednej ze szkół znajdujących się w szwedzkim mieście Örebro doszło do ataku z użyciem broni automatycznej.	OBJ
W Niemczech wynosi ono ok. 500-600 euro.	OBJ
Nagranie opublikowała w mediach społecznościowych pizzeria, sprzed której zerwano flagę. 	OBJ
Ale coś poszło nie tak.	SUBJ
Aktywne skanowanie charakterystyki urządzenia do celów identyfikacji.	OBJ
Drożyzna lekowa rujnuje Polaków	SUBJ
"""Geniusz zbrodni"" zgubił telefon "	SUBJ
Wielu polskich seniorów, i nie tylko, musi wydawać nawet kilkaset złotych miesięcznie na leki, co stanowi ogromny problem szczególnie dla najuboższych. 	SUBJ
W USA mieszka nielegalnie nawet 30 tys. Polaków – szacuje MSZ.	OBJ
Rodacy w kraju są podzieleni, czy powinni być deportowani. 	OBJ
Właściciele lokalu zwrócili się z apelem do wandala.	OBJ
Dzięki publicznej zbiórce polscy naukowcy rozpoczną w Egipcie prace w grobowcu faraona Szepseskafa, który dotychczas nie był kompleksowo zbadany. 	OBJ
Zamach na Telewizję Republika nie składa się z działań przypadkowych, lecz jest starannie zaplanowany i sterowany. 	SUBJ
Na takie zgłoszenie pacjent ma trzy dni od momentu wyjazdu.	OBJ
Najważniejszą z nich jest zgłoszenie do Zakładu Ubezpieczeń Społecznych zmiany miejsca pobytu.	OBJ
Ofiarą uczestnika Marszu Niepodległości padła też tęczowa flaga wywieszona przed jedną z warszawskich restauracji.	OBJ
W treści dyrektywy zapisano:	OBJ
Treść przykuwa uwagę	OBJ
Padły cztery słowa	OBJ
Można to zrobić telefonicznie, osobiście w oddziale ZUS albo za pomocą platformy PUE ZUS. 	OBJ
Papież Franciszek, który w ostatnich tygodniach mierzył się z problemami zdrowotnymi, podczas audiencji generalnej przyznał, że znów nie czuje się najlepiej. 	OBJ
Zaczyna się rysować podział ról, w ... -	OBJ
Nic zresztą dziwnego.	SUBJ
Dokument nie jest obowiązkowy, ale jest dobrym argumentem, jeśli ZUS będzie próbował podważyć zasadność wyjazdu	SUBJ
Donald Tusk wykluczył możliwość, by Polska, w związku z przyjętym przez UE paktem migracyjnym, musiała płacić za imigrantów, których nie przyjmie z innych państw w ramach relokacji. 	OBJ
Co ciekawe może też rekreacyjnie wyjechać np. na wakacje czy ferie zimowe.	SUBJ
I choć wideo zostało już usunięte z profilu pizzerii, to obecnie żyje własnym życiem i wciąż jest udostępniane w internecie przez rozbawionych użytkowników sieci. 	SUBJ
W ostatnim czasie administracja Donalda Trumpa podjęła działania prowadzące do usunięcia lub modyfikacji treści dotyczących społeczności LGBTQ z rządowych stron internetowych – informuje NBC News.	OBJ
Po wpadce szybko podnosi się i oddala ze swoimi towarzyszami.	OBJ
Wspomniane pozwy pokazują, jakiego elementu swojej biografii były „król Europy” boi się najbardziej. 	SUBJ
"Chciał przykozaczyć i po Marszu Niepodległości wykazać się ""patriotyczną"" postawą. "	SUBJ
Przed wyjazdem na ferie warto też porozmawiać ze swoim lekarzem prowadzącym i poprosić o zaświadczenie o braku przeciwwskazań do podróżowania.	OBJ
Użycie dokładnych danych geolokalizacyjnych.	OBJ
Przewracając się, zgubił telefon. 	OBJ
Te były podczas tegorocznego marszu palone przy wtórze piosenek szkalujących osoby homoseksualne.	OBJ
Przyczyną medialnej burzy jest dyrektywa z 14 maja 2024 r. w sprawie ustanowienia norm dotyczących przyjmowania osób ubiegających się o ochronę międzynarodową.	OBJ
Powinno być możliwe przyznanie świadczenia na codzienne wydatki”.	OBJ
Ten Marsz Niepodległości zapisał się czarną kartą w historii	SUBJ
- W ciągu trzech dni od wyjazdu należy dopełnić formalności w Zakładzie Ubezpieczeń Społecznych	OBJ
Pacjent na takim zwolnieniu może bez problemu realizować swoje codzienne zadania, chodzić na spacery, spotykać się z przyjaciółmi czy uprawiać sporty. 	OBJ
- W 2023 r. lekarze psychiatrzy wystawili 1,4 mln zwolnień lekarskich, a ich liczba rośnie z roku na rok	OBJ
Takich zachowań było nieporównanie mniej – podjęło je 15,7 tys. osób – wynika z danych Straży Granicznej podsumowujących miniony rok. 	OBJ
Za brexitem stali Tusk i Merkel	OBJ
10 tys. zł na uchodźcę w Polsce – prognoza polityczna bez podstawy prawnej	SUBJ
Na celowniku uczestników marszu znajdują się głównie mniejszości seksualne i ich symbole — m.in. tęczowe flagi.	OBJ
Czego boi się Tusk?	OBJ
Ten po odejściu mężczyzny podniósł siedzący przy stoliku klient restauracji i oddał go jej pracownikom.	OBJ
To efekt rozporządzeń wykonawczych podpisanych przez nowego prezydenta USA.	OBJ
Co ciekawe, w obu wypadkach wściekłość Tuska wywołało to samo. 	SUBJ
Rozporządzenie z 6 października 2023 r. w sprawie wysokości pomocy dla cudzoziemców ubiegających się o udzielenie ochrony międzynarodowej określa konkretne stawki na jakie mogą liczyć imigranci w Polsce.	OBJ
Z roku na rok liczba L4 wydawanych przez tych konkretnych specjalistów rośnie.	OBJ
Jak wynika z badania przeprowadzonego przez pracownię Opinia24 dla Radia ZET, pierwsze miejsce w nowym sondażu partyjnym – z wynikiem 32 proc. – zajmuje Koalicja Obywatelska. 	OBJ
Nowacka nie przejęzyczyła się.	SUBJ
Najczęściej wśród powodów zwolnienia lekarskiego od psychiatry wymienia się reakcję na ciężki stres.	OBJ
Niektórzy z powodu wysokich cen rezygnują.	OBJ
„Mnie nikt w Unii Europejskiej nie ogra” – mówił w grudniu 2023 roku Donald Tusk.	OBJ
Z Santorini – wyspy będącej jednym z najpopularniejszych turystycznych miejsc w Grecji – uciekają mieszkańcy i turyści.	OBJ
Ale w nowej rozgrywce Europy z Waszyngtonem Warszawa ogrywana jest raz za razem.	OBJ
Jedno jest niezmienne: przerzucani do nas cudzoziemcy nie chcą zostać w Polsce, ich celem są kraje zachodnie – głównie Niemcy. 	SUBJ
Najgorsza ze wszystkich twarz zdrady	SUBJ
W odróżnieniu jednak od zwolnień lekarskich od innych specjalistów L4 od psychiatry jest bardziej elastyczne.	OBJ
Jest bardzo prorosyjska, nawołuje do odbudowy i wznowienia przesyłu gazu z Nord... -	OBJ
Zmianę miejsca pobytu należy również zgłosić pracodawcy.	OBJ
Podczas strzelaniny zginęło co najmniej 10 osób – poinformowała szwedzka policja.	OBJ
- Dobrze dbasz o zdrowie?	SUBJ
Marsz Niepodległości organizowany 11 listopada w Warszawie od kilku lat jest przede wszystkim pokazem homofobii i nietolerancji narodowców, przykrytych wartościami patriotycznymi. 	SUBJ
Powodem jest to, że poważnie nasiliła się aktywność sejsmiczna. 	OBJ
- Zwolnienie lekarskie od psychiatry jest bardziej elastyczne, pacjent może bez problemu wyjechać na wakacje czy ferie zimowe	OBJ
Nie zauważył tylko jednego — że podczas upadku z kieszeni wypadł mu telefon komórkowy.	OBJ
"""Cześć kolego, chętnie wymienimy flagę na telefon, zapraszamy do baru"" — napisali pod filmikiem. "	OBJ
To świadoma strategia	SUBJ
Ich zdaniem nie zwiększy bezpieczeństwa, a narusza prawa człowieka. 	OBJ
W 2023 r. lekarze psychiatrzy wystawili 1,4 mln zwolnień lekarskich. 	OBJ
Przewodniczący Platformy Obywatelskie naprawdę się „rozkręcił”, jeśli chodzi o pozwy sądowe. 	SUBJ
Przysługuje również jednorazowa pomoc na zakup odzieży w wysokości 140 zł (§ 2 rozporządzenia).	OBJ
- Zgodnie z intencją, która jest zawarta w tej dyrektywie, świadczenie na rzecz migranta ma być podobne we wszystkich krajach UE. 	OBJ
"Szczególnie ważne są tu cyfry ""1"" i ""2"". "	OBJ
Przypomnienie tego, jak skrajnie prorosyjskim był (i jest) politykiem, jak opłacalne dla Putina były czasy jego rządów w Polsce. 	SUBJ
„Oberwało się” Telewizji Publicznej, a także „Gazecie Polskiej”. 	OBJ
Podobnie jak w przypadku zaświadczeń od innych specjalistów, L4 od psychiatry płatne jest 80 proc. podstawy wynagrodzenia. 	OBJ
Nagrali go po Marszu Niepodległości.	OBJ
To był inny Putin?Trzeba bowiem przypomnieć, co jeszcze bardziej pokazuje kuriozalność tych pozwów, że 	SUBJ
„świadczenie na codzienne wydatki powinno być przyznawane osobom ubiegającym się o ochronę międzynarodową jako część świadczeń materialnych w ramach przyjmowania, tak aby osoby te mogły korzystać z minimalnego stopnia samodzielności w swoim życiu codziennym. 	OBJ
- Według stanu na 31 marca 2024 r. z pomocy socjalnej korzystało prawie 5,2 tys. obcokrajowców, z czego niespełna 700 osób przebywało w ośrodkach dla cudzoziemców – ujawnia cytowany przez wp.pl urząd do spraw cudzoziemców.	OBJ
Kiedy dodamy do tego wyżywienie, mieszkanie i możliwość połączenia rodzin to wychodzi, że u nas taka rodzina 2+2 będzie miała dochód ok. 10 tys. zł - uznał polityk PiS w wypowiedzi dla serwisu wpolityce.pl. 	OBJ
Jak widać, jedyną metodą, jaką uznaje były premier, jest knebel prawny. 	SUBJ
Teraz z jego kompromitacji śmieje się cała Polska.	SUBJ
Policjanci, strażacy oraz strażnicy graniczni otrzymają dodatek mieszkaniowy w wysokości od 900 do 1800 zł - ogłosił podczas wtorkowej konferencji prasowej premier Donald Tusk. 	OBJ
W najnowszym odcinku podcastu „Pałac Prezydencki” Michał Kolanko rozmawia z Anną Górską, szefową sztabu Magdaleny Biejat. 	OBJ
Zwolnienie lekarskie od psychiatry może mieć różną długość, ale maksymalnie może trwać 182 dni robocze, czyli ok. pół roku. 	OBJ
Imigrant przebywający w ośrodku może liczyć na okrągłe 50 zł miesięcznie (§ 4 rozporządzenia).	OBJ
Jak reguluje świadczenia dla imigrantów dyrektywa UE?	OBJ
Przed podróżą trzeba jednak dopełnić kilku formalności.	OBJ
Na nagraniu widać, jak osobnik z biało-czerwonym szalem na szyi wchodzi na krzesło, szarpie za flagę, a następnie traci równowagę i spada z krzesła, przewracając się na chodniku. 	OBJ
Dla każdego, kto nie jest oczadziałym „Wyborczą” i TVN-em bądź członkiem KOD-u czy podobnej organizacji, sprawa jest oczywista. 	SUBJ
– Straż Graniczna dała wyraźny sygnał Białorusi i światu, że polska granica jest chroniona, i nikt nie zaakceptuje otwarcia szlaku nielegalnej migracji przez Polskę do innych krajów Europy Zachodniej. 	SUBJ
Po rekordowym 2021 r. i szturmie na granicę z Białorusią, gdy 40 tys. osób próbowało nielegalnie przedostać się do Polski, w roku ubiegłym presja migracyjna osłabła. 	OBJ
Kampania prezydencka nabiera tempa, a kandydaci i kandydatki coraz intensywniej zabiegają o głosy wyborców. 	OBJ
Oznacza, że nie możesz wychodzić z domu 	OBJ
Po tym, jak w środowy poranek doszło do strzelaniny w pobliżu jednej ze stacji metra w Brukseli, belgijska policja poszukuje uzbrojonych mężczyzn. 	OBJ
Jakie są kluczowe założenia kampanii kandydatki Nowej Lewicy?	OBJ
Rozliczenie z przeszłością jest - zdaniem ankietowanych w sondażu United Surveys dla Wirtualnej Polski - warunkiem niezbędnym do rozszerzenia NATO i Unii Europejskiej o Ukrainę.	OBJ
Donald Tusk był najbardziej prorosyjskim premierem w dziejach III RP, człowiekiem, który, przez wiele lat z bliskich kontaktów z Moskwą i Putinem uczynił swój atut wyborczy. 	SUBJ
Zaczęło się od tego, że upomnieliśmy się o ofiary powodzi i zapytaliśmy o pieniądze... 	OBJ
Dlatego nie warto liczyć na to, że „na pewno nic się nie stanie” albo „jakoś tam będzie” 	SUBJ
Użycie określeń „świadczenie na codzienne wydatki” oraz „minimalny stopień samodzielności” jest sprzeczne z teoriami polityka PiS zwiastującego ogromny socjał dla imigrantów w Polsce.	SUBJ
"Na transparentach można było przeczytać hasła: ""Beata niestety, twój rząd obalą kobiety"", ""Potrzebują dziś obrony nasze siostry, matki, żony"", ""Ratujmy kobiety przez wyborem czy iść do nieba czy do więzienia"". "	OBJ
W Poznaniu zatrzymano trzy osoby; rannych zostało pięciu policjantów.	OBJ
- Wszystkie praktycznie te zgromadzenia przebiegały w sposób niezwykle spokojny i bezpieczny i to było efektem dobrej, jak zwykle profesjonalnej, służby pełnionej przez polskich policjantów w tych miejscach - powiedział komendant policji. 	OBJ
Policja prowadzi takie statystyki jedynie ze względów bezpieczeństwa, nie ze względów politycznych. 	OBJ
"Z kolei Ratusz podał, że w ""czarnym proteście"" wzięło udział ok. 30 tys. osób "	OBJ
"Na poniedziałek zaplanowano przede wszystkim spotkania w mniejszych grupach i dyskusje na takie tematy jak: ""Polityka a aborcja"", ""Intymne życie łodzianek"", a także przemarsz ul. Piotrkowską, w manifestacji wzięło udział mniej osób niż w niedzielnej demonstracji. "	OBJ
To właśnie tam według szacunków ustalonych na podstawie zdjęć, zebrało się kilkanaście tysięcy osób. 	OBJ
• Demonstranci protestowali przeciwko zaostrzeniu ustawy antyaborcyjnej	OBJ
W niektórych miastach mężczyźni przygotowywali dla strajkujących posiłki.	OBJ
Kilkanaście tysięcy osób wzięło także udział w manifestacji we Wrocławiu.	OBJ
- Z informacji, które policja przekazała do Centrum Zarządzania Kryzysowego UM Wrocław wynika, że marsz, który szedł od pl. Hallera do Rynku, liczył ok. 10 tys. osób. 	OBJ
Według policji na placu przebywało ok. 4 tys. osób.	OBJ
W wielu miastach odbyły się manifestacje, największa z nich - w stolicy. 	OBJ
Manifestowały i kobiety i mężczyźni.	OBJ
"""Musimy działać, musimy protestować, bo prawda jest taka, że na razie żadne inne sposoby nie działają. "	SUBJ
W Warszawie dni otwarte ogłosiły m.in. Centrum Praw Kobiet i Federacja na rzecz Kobiet i Planowania Rodziny, w Łodzi w Centrum Praw Kobiet na protestujące czekały kawa i ciastka. 	OBJ
Uczestników musiało być jednak sporo - jak widać na zdjęciach z niedzielnego marszu, protestujący zajmowali ul. Piotrkowską od pl. Wolności aż do Centralu przy al. Adama Mickiewicza. 	OBJ
• W głównych manifestacjach wzięło udział kilkadziesiąt tysięcy osób	OBJ
Prawicowa propaganda wylewająca się z telewizorów zderzyła się z rzeczywistością, z gniewem setek tysięcy kobiet, które mają dość odbierania sobie godności - napisało Razem na swoim profilu na Facebooku. 	SUBJ
- Na świecie tysiące ludzi zebrały się na protestach solidarnościowych.	OBJ
Dodał, że odnotowano siedem incydentów. 	OBJ
Według policji manifestacja przebiegła spokojnie.	OBJ
Dodał, że największe zgromadzenia odbyły się we Wrocławiu, gdzie było ok. 20 tysięcy uczestników, w Warszawie - 17 tys. uczestników i w Poznaniu - ok. 8 tys. 	OBJ
Na Pomorzu najliczniejsze protesty miały miejsce w Gdyni i Gdańsku.	OBJ
"Uczestnicy protestu trzymali w rękach czarne balony i transparenty z napisami m.in. ""Oprócz macic mamy mózgi!"", ""Moje ciało, mój wybór!"", ""Dzisiaj strajkujemy, jutro wyjedziemy! "	OBJ
Pokazałyśmy, że sprzeciw jest powszechny i że są nas tysiące: w każdym mieście, w każdej gminie, w całym kraju. 	SUBJ
"Marsz rozpoczął się na skrzyżowaniu ulic Powstańców Śląskich i Hallera, demonstrujący krzyczeli do ludzi: ""Wrocławianie chodźcie z nami to jest wojna z kobietami"", dzięki czemu do kolumny dołączali kolejni protestujący. "	OBJ
Nie chcemy niejasności, że my podamy jedną liczbę, np. szacunki organizatora będą inne - powiedział Wirtualnej Polsce kom. Grzegorz Gubała z małopolskiej policji. 	OBJ
Organizowano też m.in. bezpłatne treningi, zajęcia jogi oraz wycieczki, a także rozmaite warsztaty i happeningi. 	OBJ
Zostaniecie sami!	SUBJ
"Na czele marszu, niesiono transparent z napisem ""Strajk Kobiet"". "	OBJ
Przed teatrem zgromadziła się kilkudziesięcioosobowa grupa, która rozeszła się przed godz. 20. 	OBJ
"W Warszawie padał deszcz, więc ""czarnemu protestowi"" towarzyszyły kolorowe parasole. "	OBJ
Od wczoraj zbieramy relacje od osób biorących udział w protestach oraz doniesienia mediów, liczymy się na zdjęciach - czytamy we wpisie. 	OBJ
Policja nie chce udzielić dokładnych informacji na temat szacunkowej liczby protestujących w poniedziałek we Wrocławiu.	OBJ
- Nie ufamy reżimowym mediom, że podadzą prawdziwe informacje. 	SUBJ
Późnym popołudniem uczestnicy manifestacji przeszli z pl. Zamkowego przed Sejm; następnie część z nich postanowiła pójść pod Teatr Polski, gdzie odbywała się gala z okazji 35-lecia Tygodnika Solidarność, z udziałem m.in. prezydenta Andrzeja Dudy, premier Beaty Szydło oraz przedstawicieli rządu. 	OBJ
Nie można decydować za kogoś co ma robić ze swoim ciałem – to odbieranie podstawowych praw człowiekowi.	SUBJ
"Uczestnicy, głównie kobiety, przemaszerowali przez centrum miasta, skandując m.in. ""Prawa kobiet prawami człowieka"". "	OBJ
"• W mediach pojawiają się kontrowersyjne komentarze nt. ""Strajku Kobiet"" "	OBJ
W ciągu dnia kobiety w stolicy Małopolski rozdawały ulotki, zawieszały czarne wstążki na pomnikach, drzewach, przystankach. 	OBJ
Po południu manifestanci przenieśli się na plac Solidarności, gdzie dołączyli do nich także protestujący z Sopotu i Gdyni. 	OBJ
Politycy owszem – wygrali wybory, ale to nie znaczy, że ich głos jest głosem całego społeczeństwa. 	SUBJ
"W nocy z niedzieli na poniedziałek na krzyżu na Giewoncie pojawił się baner z napisem: ""Brońmy kobiet od Giewontu do Bałtyku"". "	OBJ
To jest kpina z ważnych kwestii	SUBJ
W poniedziałek odbywał się strajk kobiet - protest wobec możliwego zaostrzenia przepisów dot. aborcji.	OBJ
Dodała także, że jest pozytywnie zaskoczona frekwencją, i że mimo ulewnego deszczu tak wiele mieszkańców miasta uczestniczy w proteście. 	OBJ
W Gdyni protest zaczął się w południe i trwał około trzech godzin.	OBJ
W Gdańsku na placu naprzeciwko Dworca Głównego od rana przebywało kilkaset ubranych na czarno osób, głównie kobiet. 	OBJ
Zgromadzenie rozpoczęło się po południu na pl. Zamkowym w Warszawie.	OBJ
Obecna na proteście żona prezydenta Poznania Joanna Jaśkowiak powiedziała PAP, że ma nadzieję, że dzięki tego typu akcjom politycy zrozumieją, że przy podejmowaniu decyzji należy się liczyć ze zdaniem społeczeństwa. 	OBJ
• Łącznie w protestach wzięło udział ok. 98 tys. osób	OBJ
Byli tam także przeciwnicy aborcji, którzy - w odpowiedzi na hasła wykrzykiwane przez protestujących - inicjowali modlitwy.  Łódź	OBJ
Według organizatorów - wzięło udział ponad 20 tys. osób - zarówno kobiet, jak i mężczyzn. 	OBJ
Liczba uczestników protestu zmieniała się, ale zdaniem gdyńskiej policji w kulminacyjnym momencie było ich około 2,5 tys. 	OBJ
Uczestniczyło w nich ok. 98 tys. osób - poinformował komendant główny policji nadinsp. Jarosław Szymczyk.	OBJ
"Marsz w obronie praw kobiet ""Jestem! Myślę! Decyduję!"" ulicami Łodzi przeszedł w niedzielę. "	OBJ
"""Przede wszystkim chodzi jednak o to, że jeśli nie zaprotestuję, będę mogła mieć pretensje tylko i wyłącznie do siebie. "	OBJ
Jak dodali, liczenie trwa - czekają na dane o uczestnikach z kolejnych miast.	OBJ
"W Warszawie po ""czarnym proteście"" policja przedstawiła zarzut popełnienia wykroczenia polegającego na zakłócaniu legalnego zgromadzenia czterem 18-latkom. "	OBJ
Służby porządkowe szacują, że w kulminacyjnym momencie uczestniczyło w niej ok. 17 tys. osób, choć - jak zastrzegają - była duża rotacja. 	OBJ
"To na razie strajk ostrzegawczy, ale nie cofniemy się przed niczym"" – powiedziała uczestniczka protestu Dominika Suwalska, która, aby uczestniczyć w proteście, wzięła dzień urlopu w pracy. "	OBJ
- Policja odnotowała w poniedziałek 143 zgromadzenia związane z tzw. czarnym protestem.	OBJ
Natomiast w manifestacji, w kulminacyjnym momencie w Rynku, uczestniczyło ok. 20 tys. osób - przekazała Wirtualnej Polsce Małgorzata Szafran z biura prasowego UM. 	OBJ
"Główna manifestacja ""Godzina K"" rozpoczęła się ok. godz. 18 na Rynku. "	OBJ
- Były to bardzo drobne incydenty i tylko jeden z nich, ten poznański, miał charakter zbiorowy - poinformował Szymczyk. 	OBJ
"Skandowano hasła: ""Chcemy kochać, nie umierać"", ""Jestem, czuję, decyduję"", ""Wolny wybór"", ""Kobiet prawa - ważna sprawa"", ""Moje ciało, moja broszka"" ""Wściekłe macice nie cofną się przed niczym"", ""Solidarność jest kobietą"". "	OBJ
- Czarny Marsz w Łodzi - największa manifestacja od zmiany ustroju - napisał jeden z uczestników na Twitterze.	OBJ
"To tak jak z chodzeniem na wybory"" – powiedziała. "	OBJ
"Według szacunków organizatorów i policji, ok. 8 tys. osób, mimo intensywnego deszczu, uczestniczyło w poniedziałek w centrum Poznania w ""czarnym proteście"". "	OBJ
"W Krakowie z Rynku Dębnickiego na Rynek Główny przeszedł ""czarny masz milczenia"". "	OBJ
Nie podajemy mediom takich informacji, przekazujemy je jedynie organizatorowi. 	OBJ
Demonstrujących było na tyle dużo, że przez Most Dębnicki kolumna protestujących przechodziła przez 35 minut. 	OBJ
Protestom towarzyszyły różnego rodzaju akcje, np. dni otwarte w organizacjach broniących praw kobiet. 	OBJ
"Według organizatorów w ""czarnym marszu"" wzięło udział ok. 15 tys. osób. "	OBJ
Lekarz ustala takie rzeczy w toku diagnostyki, ale nie widzę powodu, dlaczego miałoby to się znajdować w uzasadnieniu zaświadczenia, które idzie do lekarza ginekologa. 	SUBJ
W mojej ocenie potwierdza to, że lekarze po prostu troszeczkę inaczej interpretują te przesłanki, niż powinno to mieć miejsce, patrząc na treść przepisów - podsumowała dr Sabrina Mana-Walasek w rozmowie z Gazeta.pl. - Cieszę się jednak, że psychiatrzy i lekarze uznają tę przesłankę psychiatryczną, czyli zdrowie psychiczne, jako element zdrowia, bo też słyszałam różne głosy na ten temat. 	OBJ
Wszystkie wytyczne takich towarzystw lekarskich i naukowych, jeżeli są oparte na aktualnej wiedzy medycznej, mogą mieć wpływ na ocenę, czy dana osoba wykonująca zawód lekarza w konkretnej sytuacji wykonała czynności w sposób prawidłowy. 	OBJ
Rozszerza ona kwestię związaną z przesłankami do przerwania ciąży z przyczyn zdrowotnych, wskazując na to, że to musi być jakieś poważne zagrożenie. 	OBJ
"Dr Sabrina Mana-Walasek wyjaśniła, że ""wytyczne nie są wiążące i nie stanowią źródła prawa, ale mają wpływ na ocenę należytej staranności w wykonywaniu zawodu"". "	OBJ
"Jak wskazała adwokatka, ""są dwie rzeczy, które ją uderzyły, kiedy przeczytała wytyczne"". "	OBJ
Jest to zbyt ingerujące w prywatność pacjentki, która musi uzasadniać, że zasługuje na tę aborcję, bo np. jest w trudnej sytuacji finansowej lub nie ma męża - oceniła prawniczka. 	OBJ
"""To absolutnie nie powinno mieć miejsca w gabinecie"". "	OBJ
Wizyta zdalna jest dopuszczalną, legalną opcją korzystania ze świadczeń medycznych, więc w mojej ocenie jest to trochę bezprawne ograniczanie praw pacjentek. 	SUBJ
To są wartości, które ocenia ustawodawca, a nie lekarz, który ma wystawić zaświadczenie. 	SUBJ
Czytając o tym, zastanawiam się, czy rzeczywiście ustalenie tego, czy pacjentka pracuje, ma męża, dzieci ma jakikolwiek wpływ na prawo do aborcji i to, czy ta ciąża zagraża zdrowiu psychicznemu. 	SUBJ
Ten aspekt został zupełnie pominięty - podkreśliła ekspertka.	OBJ
Adwokatka alarmuje o nowych wytycznych ws. aborcji	OBJ
"Wytyczne zawierają między innymi wzmiakę, że ""wydanie orzeczenia/zaświadczenia powinno być zawsze poprzedzone osobistym badaniem pacjentki"", co wyklucza możliwość przeprowadzenia konsultacji w formie online i telefonicznie. "	OBJ
- Wtedy moim zdaniem już niczym się nie wytłumaczy - podkreśliła prawniczka.	OBJ
Uważam, że wykładnia przepisów Polskiego Towarzystwa Psychiatrycznego, która została dokonana w tych wytycznych, odbiega od zasad prowadzenia wykładni prawnej. 	OBJ
"Wątpliwości budzi również wątek ""uzasadnionego opisania informacji z anamnezy (wywiadu lekarskiego - przyp. red.), z uwzględnieniem sytuacji rodzinnej i wywiadu społeczno-ekonomicznego"". "	OBJ
Oceniając prawidłowość wykonywania zawodu między innymi w kontekście kwestii związanych z odpowiedzialnością dyscyplinarną lekarza, sięga się nie tylko do przepisów, ale również takich wytycznych - poinformowała adwokatka w rozmowie z Gazeta.pl. 	OBJ
Przykładem jest weryfikacja stanu rodzinnego czy sytuacji życiowej pacjentki - wyjaśniła ekspertka.	OBJ
To druga kwestia, która została niepotrzebnie wskazana w tych wytycznych. 	SUBJ
Dotyczy ona zbierania danych o pacjentce, których nie trzeba ujawniać w kontekście przesłanki zdrowotnej. 	OBJ
"Mogę sobie wyobrazić, że lekarz, który ma poglądy antyaborcyjne, może wykorzystywać taką wykładnię do odmowy aborcji - wskazała adwokatka, ale podkreśliła, że ""jeżeli chodzi o odmowę aborcji, bo lekarz uzna, że zagrożenie życia lub zdrowia wystąpiło, ale nie było poważne, to już jest kwestia oceny prawnej nieprawidłowego zastosowania ustawy"". "	OBJ
Tego ustawodawca nie przewidział i do tej pory nie było to w ten sposób wykładane przez prawników, tylko przez lekarzy. 	OBJ
"Zdaniem ekspertki wytyczne są ""dosyć szkodliwe i krzywdzące dla pacjentek"". "	OBJ
Jeżeli kobieta ma uprawnienia do legalnej aborcji zapewniane przez prawo, lekarz nie powinien ważyć wartości, których sam nie jest w stanie ocenić. 	OBJ
"Lekarze wskazali, że ""życie dziecka poczętego jest wartością społeczną"", która musi być chroniona przez lekarzy, ale nie wspomnieli, że prawo do zdrowia też jest wartością społeczną i prawem człowieka. "	OBJ
"Polskie Towarzystwo Psychiatryczne w piątek 18 października opublikowało ""wytyczne dla lekarzy psychiatrów, dotyczące wydawania orzeczenia stwierdzającego zagrożenia dla życia lub zdrowia kobiety ciężarnej jako przesłanki legalnego przerwania ciąży"". "	OBJ
To absolutnie nie powinno mieć miejsca w gabinecie lekarskim, ponieważ lekarz jest od oceny stanu zdrowia pacjentek - zaznaczyła dr Sabrina Mana-Walasek. 	OBJ
Dziwi mnie to wykluczenie, ponieważ psychiatrzy bardzo często pracują zdalnie, a wiele pacjentek nie jest w stanie przyjść osobiście na wizytę. 	SUBJ
To wygląda, jakby lekarze nie ufali pacjentkom i zakładali, że któraś okłamie lekarza - powiedziała dr Sabrina Mana-Walasek. 	OBJ
To jedyny plus tych wytycznych - dodała.	OBJ
Wytyczne ministerstwa jasno mówiły, że ustawodawca nie wymaga, żeby było to poważne zagrożenie a wytyczne psychiatrów mówią co innego - powiedziała dr Sabrina Mana-Walasek. 	OBJ
- Pierwszą rzeczą jest postawienie dziwnej hierarchii dóbr prawnych, które stoją w konflikcie w przypadku przerwania ciąży. 	SUBJ
O ocenę wytycznych i to, jakie efekty mogą wywołać, zapytaliśmy stałą doradczynię komisji nadzwyczajnej do rozpatrzenia projektów ustaw dotyczących prawa do przerywania ciąży i współzałożycielkę grupy Prawniczki Pro Abo dr Sabrinę Manę-Walasek. 	OBJ
- Wytyczne mogą więc zmienić praktykę, choć mam nadzieję, że tak się nie stanie i lekarze zauważą, że mamy pewną niespójność między wytycznymi Ministerstwa Zdrowia a Polskiego Towarzystwa Psychiatrycznego. 	SUBJ
Do weryfikacji stanu zdrowia psychicznego nie jest przecież potrzebna wizyta osobista ani fizyczne zbadanie pacjentki, tak jak w przypadku np. wizyty ginekologicznej. 	OBJ
- Przede wszystkim dlatego, że pozostawiają bardzo duże pole do nadużyć i do arbitralnych decyzji lekarza. 	SUBJ
Jestem szefem Platformy na Dolnym Śląsku i ja będę szefem kampanii u siebie w regionie - mówił w rozmowie z nami wiceminister.	OBJ
"""Ruch w dobrą stronę"" "	SUBJ
Firma Graszewicza świadczyła również usługi promocyjne dla gminy Ząbkowice Śląskie w 2021 r.	OBJ
W sierpniu 2023 r. Kontecka opublikowała artykuł o dolnośląskich kandydatach Koalicji Obywatelskiej do Sejmu zilustrowany zdjęciem Michała Jarosa w towarzystwie m.in. Barbary Nowackiej.	OBJ
Kiedy bezpośrednio próbowaliśmy uzyskać od niego komentarz, nie zareagował na naszą prośbę o kontakt. 	OBJ
"Burmistrzem Polkowic w tamtym czasie był Łukasz Puźniecki, były członek zarządu dolnośląskiej Platformy, od 2018 r. działający jako bezpartyjny pod szyldem ""Lepsze Polkowice"". "	OBJ
Tak się zarabia w dolnośląskiej Platformie	OBJ
Po gminie osobiście oprowadzał go burmistrz.	OBJ
"Inne samorządy na Dolnym Śląsku zapytaliśmy: ""Czy w okresie od początku 2020 roku zawierali Państwo jakiekolwiek umowy o świadczenie usług ze spółką Morrismarlowe, panem Maurycym Graszewiczem lub z innymi podmiotami, których beneficjentem jest pan Maurycy Graszewicz"". "	OBJ
Latem ubiegłego roku wizytę w Twardogórze złożył poseł Michał Jaros.	OBJ
Umowa opiewała na 12 tys. zł.	OBJ
Wartość kontraktów: 65 400 zł.	OBJ
Zakres był taki sam jak w przypadku pozostałych samorządów - publikacje w serwisach spółki i obsługa mediów społecznościowych.	OBJ
Nie zareagował również na naszą wiadomość w serwisach społecznościowych, choć ją odczytał. 	OBJ
Jego zdjęcie reklamowało chociażby cykl spotkań polityków PO z rolnikami w czasie kampanii parlamentarnej.	OBJ
Skomentował propozycję Trzaskowskiego.	OBJ
Dotarliśmy do umów, które powiat trzebnicki w latach 2020-2023 zawierał z agencją Morris Marlowe. 	OBJ
Gdy sprawą zainteresowała się Wirtualna Polska, Jaros wycofał się z poparcia dla nominacji Graszewicza. 	OBJ
W sprawie zawartych umów z samorządami pytania do Graszewicza wysłaliśmy już pod koniec stycznia.	OBJ
Z kolei po zmianie władzy partnerka Graszewicza została zatrudniona w lokalnej spółce Skarbu Państwa.	OBJ
Gmina Twardogóra współpracowała z kolei z obiema spółkami.	OBJ
Jaros to zresztą stały bohater artykułów Konteckiej.	SUBJ
Umowy zawierano z wolnej ręki.	OBJ
- Wezmę to na siebie.	OBJ
Od tego czasu nie publikowała już.	OBJ
Z informacji przesłanych Wirtualnej Polsce przez starostwo wynika, że firma Graszewicza w ciągu czterech lat zarobiła na tych umowach 107 tys. zł. 	OBJ
Jak ujawniliśmy w styczniu, mógł zostać szefem dolnośląskiego sztabu Rafała Trzaskowskiego. 	OBJ
Wójtem gminy w tym czasie był Ryszard Pacholik, który w ubiegłym roku dostał od Koalicji Obywatelskiej pierwsze miejsce na liście w wyborach samorządowych do rady powiatu wrocławskiego. 	OBJ
Na nasze pytania o wysokość zarobków Dozamel nie odpowiedział, zasłaniając się tajemnicą przedsiębiorstwa. 	OBJ
- Jeśli publikowanie prawdziwych wypowiedzi ktoś nazywa hejtem, jest to raczej problem tych wypowiedzi - tłumaczył się Graszewicz. 	OBJ
Większość z nich to typowe materiały promujące samorządy: informacje o darmowych poradach prawnych czy wakacyjnym teatrze dla dzieci, ale jest też trochę artykułów dotyczących życia Platformy Obywatelskiej. 	SUBJ
Do czasu publikacji nie odpisał na żadne z nich.	OBJ
O Graszewiczu zrobiło się głośno rok temu podczas kampanii samorządowej, w której Platforma popierała Jacka Sutryka w walce o reelekcję na stanowisku prezydenta Wrocławia, wybuchła tzw. afera hejterska. 	OBJ
"""Pani Dominika Kontecka jest zatrudniona w Spółce na stanowisku administracyjno-biurowym (z wynagrodzeniem niższym niż średnie wynagrodzenie obowiązujące w Spółce)"" - potwierdza Ewa Gryglewicz, dyrektor biura zarządu spółki. "	OBJ
"""Umowy zawierano z wolnej ręki"" "	OBJ
Wśród autorów podpisanych pod artykułami publikowanymi w serwisach internetowych należących do spółki Nowe Medium znajdujemy Dominikę Kontecką - prywatnie partnerkę Graszewicza i wrocławską radną Platformy Obywatelskiej.	OBJ
Starostą w Kłodzku w tym czasie był członek PO Maciej Awiżeń, który po zwycięstwie Platformy w wyborach parlamentarnych na rok został nawet wojewodą dolnośląskim. 	OBJ
W tym przypadku stroną umowy była spółka Nowe Medium.	OBJ
W 2023 r. Nowe Medium podpisało też roczną umowę o wartości 36 900 zł z podwrocławskimi Kobierzycami.	OBJ
Wyszło na jaw, że Graszewicz publikował w serwisach społecznościowych treści ośmieszające Sutryka. 	OBJ
Niemal identyczna sytuacja miała miejsce w powiecie kłodzkim w latach 2021-2023, gdzie Nowe Medium miało zawartych pięć umów o łącznej wartości 43 tys. zł. 	OBJ
W zeszłym roku był u niej nawet z wizytą w parlamencie.	OBJ
Jak wynika z nadesłanych odpowiedzi, analogiczne usługi jak w powiecie trzebnickim Graszewicz świadczył na rzecz gminy Polkowice w latach 2022-2024. 	OBJ
Gdy sprawę opisały media, Graszewicz musiał zrezygnować z kierowania sztabem, a nominacja przeszła Jarosowi koło nosa. 	OBJ
Pod kontraktami są podpisani Graszewicz i jego partyjny kolega Grzegorz Terebun, ówczesny wicestarosta powiatu, a obecnie lokalny radny powiatowy Platformy. 	OBJ
Maurycy Graszewicz uchodzi za spin doktora dolnośląskiej Platformy i jest prawą ręką szefa struktur wojewódzkich Michała Jarosa, posła i wiceministra rozwoju. 	OBJ
W tym czasie znalazła zatrudnienie we wrocławskiej spółce Dozamel należącej do państwowej Agencji Rozwoju Przemysłu.	OBJ
Gminą od wielu lat rządzi Paweł Czuliński, członek Nowoczesnej wchodzącej w skład Koalicji Obywatelskiej. 	OBJ
Skoro widzę, że ma to być punkt zwrotny w dolnośląskiej Platformie, w batalii o nie wiem co, chcę to przeciąć. 	SUBJ
Kontrakty dla swoich.	OBJ
Agencja Morris Marlowe doradzała jej wizerunkowo, a Nowe Medium obsługiwało jej profil na Facebooku i publikowało artykuły promocyjne w należącym do spółki serwisie twardogorainfo.pl. 	OBJ
Graszewicz to nie tylko działacz Platformy, ale też biznesmen. 	OBJ
Z umowy wynika, że chodziło o obsługę Facebooka powiatu oraz publikację artykułów promocyjnych w serwisach trzebnicainfo.pl, dolnyslaskinfo.pl i nowemedium.pl należących do spółki Nowe Medium Graszewicza. 	OBJ
Ostatni artykuł w dolnyslaskinfo.pl Kontecka opublikowała 3 stycznia 2024 r., zaraz po powołaniu rządu Platformy Obywatelskiej. 	OBJ
Dolnośląskie gminy i powiaty rządzone przez Platformę taśmowo podpisywały umowy na promocję i obsługę PR z firmami należącymi do działacza tej partii — dowiedziała się Wirtualna Polska.	OBJ
W serwisie dolnyslaskinfo.pl opublikowała ona aż 355 artykułów a w trzebnicainfo.pl - 25.	OBJ
Jego kandydaturę podczas grudniowego posiedzenia zarządu dolnośląskiej PO zgłosił sekretarz struktur Mateusz Jędrachowicz.	OBJ
Interpretowano to wówczas jako kampanię czarnego PR-u mającą osłabić urzędującego prezydenta i pomóc Michałowi Jarosowi w uzyskaniu rekomendacji władz PO na kandydata na prezydenta Wrocławia.	OBJ
Jest właścicielem agencji PR - Morris Marlowe i firmy Nowe Medium, która prowadzi lokalne portale na Dolnym Śląsku. 	OBJ
Jego spółki zarobiły na tych kontraktach od 2020 roku co najmniej 300 tys. zł.	OBJ
"""Przedmiotem zawartych umów było świadczenie przez Wykonawcę usług informacyjnych i ogłoszeniowych dot. działalności gminy Polkowice, burmistrza i radnych na łamach portalu nowemedium.pl"" - czytamy w odpowiedziach gminy. "	OBJ
Burmistrzem gminy jest członek PO Marcin Orzeszek, politycznie kojarzony z wicemarszałek Sejmu Monika Wielichowską. 	OBJ
Jak ustaliła Wirtualna Polska, samorządy gminne i powiatowe rządzone lub współrządzone przez Platformę w minionych latach bardzo chętnie korzystały z usług obu firm. 	OBJ
"W odpowiedzi na nasze pytania starostwo podaje, że przedmiotem kontraktów było ""świadczenie usług o charakterze reklamowym i promocyjnym, mających na celu nagłośnienia i promocję zleceniodawcy"". "	OBJ
Współpraca miała miejsce w latach 2020-2022 i obie firmy zainkasowały za nią w sumie 45 tys. zł.	OBJ
A to oznacza, że nie tylko lewicowy Madryt, lecz także wrogo nastawiona Moskwa będą miały wpływ na kwoty relokacji migrantów do Polski 	SUBJ
W jego ramach zapowiadane jest „silniejsze	OBJ
Pakt migracyjny jest także, jak można przeczytać w komunikatach Komisji Europejskiej na jego temat, odpowiedzią na zidentyfikowane niedostatki ochrony Unii Europejskiej przed falami nielegalnej migracji od czasu kryzysu migracyjnego w latach 2015–2016. 	OBJ
Oficjalne cele paktu migracyjnego to „stworzenie szybszych, płynnych procesów migracyjnych” i „ograniczenie problemu niebezpiecznych szlaków i szlaków imigracji nieuregulowanej oraz promowanie trwałych i bezpiecznych, legalnych dróg migracji”, a także lepsze dostosowanie imigracji „do potrzeb rynku pracy UE”. 	OBJ
Pakt o migracji i azylu, potocznie zwany „paktem migracyjnym”, to 10 aktów prawnych przygotowanych przez Komisję Europejską w 2020 r. 	OBJ
Polska nie przyjmie żadnych migrantów z tytułu paktu migracyjnego – zapewniał premier Donald Tusk już rok temu, kiedy w Brukseli przedstawiciele państw członkowskich Unii Europejskiej przyjmowali kolejne dokumenty dotyczące reformy wspólnego systemu azylowego. 	OBJ
Wyrok został jednak uchylony przez Sąd Apelacyjny w lutym 2022 roku.	OBJ
"""Grozi też tym, że nie będzie można ostrzegać przed pedofilią w pewnych środowiskach... "	OBJ
Wyrok skomentowała główna zainteresowana.	OBJ
W większości krajów Unii Europejskiej za podobne wypowiedzi groziłaby odpowiedzialność karna.	OBJ
Oboje jednak przyznają, że czują ulgę. 	OBJ
"Będę apelować"" - czytamy w oświadczeniu Godek. "	OBJ
Godek prosi o pomoc.	OBJ
Sytuacja ma się jednak zmienić – w Sejmie znajduje się już projekt nowelizacji kodeksu karnego, który rozszerzy katalog przestępstw z nienawiści, obejmując m.in. ochronę osób ze względu na orientację seksualną, płeć, niepełnosprawność i wiek. 	OBJ
Sąd zobowiązał ją do zaprzestania podobnych wypowiedzi w przyszłości oraz przeprosin wobec każdej z pozywających osób, choć nie publicznie, jak tego oczekiwali skarżący. 	OBJ
"Choć mówiąc te słowa, nie znałam nikogo z powodów i nie do nich ani nie o nich były moje wypowiedzi"" - napisała. "	OBJ
W uzasadnieniu stwierdzono, że skarżący nie udowodnili swojej orientacji seksualnej. 	OBJ
Uznał bowiem, że upowszechnianie przeprosin zawierających homofobiczne treści mogłoby prowadzić do wtórnej wiktymizacji. 	OBJ
"""Mam przepraszać 15 aktywistów LGBT za słowo 'zboczenie' oraz za wspominanie, że homoseksualizm często idzie w parze z pedofilią oraz że geje chcą adoptować dzieci, żeby je molestować i gwałcić. "	SUBJ
"""Nie będę przepraszać"" - pisze Godek i prosi o pomoc w pokryciu kosztów apelacji. "	OBJ
"Jak przypomina oko.press, sprawa dotyczyła wypowiedzi z 2017 roku, kiedy to działaczka antygenderowa i przeciwniczka praw reprodukcyjnych publicznie, m.in. w Polsat News, określiła osoby LGBT+ mianem ""zboczeńców"" i zestawiła homoseksualność z pedofilią. "	OBJ
Aleksandra Muzińska, współzałożycielka Funduszu dla Odmiany i jedna z powodów, przyznała w rozmowie z OKO.press, że wyrok wywołał w niej ogromne emocje. 	OBJ
Przegrała proces z aktywistami LGBT	OBJ
Muzińska podkreśliła również, że cała sprawa była obciążająca nie tylko ze względu na czas, ale także na bolesne treści, które ponownie pojawiały się w sądzie. 	OBJ
Podczas procesu działaczka urządziła w sądzie spektakl, osobiście przesłuchując skarżących i domagając się dowodów ich orientacji. 	OBJ
Odkrycie ich pogrążyło	OBJ
- Gdy usłyszałam decyzję sądu, popłakałam się - mówi. 	OBJ
Nie będę przepraszać.	SUBJ
"Nie będzie wolno formułować żadnej opinii o żadnym zjawisku"". "	OBJ
Po siedmiu latach walki, szesnaścioro przedstawicieli społeczności LGBT+ – w tym prawniczki, dziennikarze, naukowcy, artyści i aktywiści – wygrało proces przeciwko Kai Godek w sprawie naruszenia dóbr osobistych. 	OBJ
Sąd domagał się opinii biegłego seksuologa lub zaświadczeń lekarskich potwierdzających, że powodowie są gejami, lesbijkami lub osobami biseksualnymi. 	OBJ
Witold Klaus, kolejny z pozywających, dodał, że w trakcie procesu musieli szczegółowo opowiadać o swoim życiu prywatnym, udowadniając przed sądem, jak trudno żyje się osobom LGBT+ w Polsce. 	OBJ
25 lutego 2025 roku Sąd Okręgowy w Warszawie, który ponownie rozpatrywał sprawę, uznał, że Kaja Godek naruszyła godność powodów. 	OBJ
Sędzia Małgorzata Kuracka uznała, że słowa Kai Godek stanowiły społecznie nieakceptowalną mowę nienawiści. 	OBJ
Wcześniej sprawa została oddalona przez sąd pierwszej instancji, który uznał, że dobra osobiste mogą zostać naruszone tylko wtedy, gdy obraźliwe słowa są skierowane do konkretnych osób lub jasno określonej grupy. 	OBJ
Proces trwał tak długo, że wielu z nich straciło nadzieję na pozytywne rozstrzygnięcie. 	OBJ
"Dodała, że ""uprawomocnienie się tego wyroku mogłoby oznaczać w największym skrócie, że wszyscy możemy pozywać wszystkich o jakiekolwiek słowa, nie trzeba mówić o konkretnej osobie. "	OBJ
W Polsce natomiast kodeks karny nadal nie penalizuje homofobicznej mowy nienawiści, dlatego powodowie zdecydowali się na ścieżkę cywilną. 	OBJ
Aktywistka zaapelowała o finansowe wsparcie jej Fundacji Życie i Rodzina w celu pokryciu kosztów apelacji.	OBJ
Twierdziła także, że jest ofiarą nagonki i niesprawiedliwości. 	SUBJ
Klaus natomiast podkreślił, że wyrok jest przełomowy, bo jasno pokazuje, iż przekraczanie granic wolności słowa i naruszanie godności innych ludzi nie jest akceptowalne. 	OBJ
- Kaja Godek w trakcie rozprawy powtarzała raniące określenia, nazywała nas mitomanami i megalomanami, podważała naszą przynależność do społeczności LGBT+ - wspomina. 	OBJ
- To sygnał dla całej społeczności, że można skutecznie walczyć o swoje prawa na drodze cywilnej - mówi Muzińska, dodając, że ma nadzieję na dalsze zmiany prawne w zakresie ochrony przed mową nienawiści. 	OBJ
