sentence	prediction
"Dalla premier ""viltà istituzionale""."	OBJ
Ma in ballo c’è di più.	SUBJ
Meglio che di sinistra.	SUBJ
La paura di chiamare le persone con il loro nome	OBJ
MAGI - Riccardo Magi di Più Europa è sarcastico.	OBJ
online, ma anche nella narrativa, sui giornali, nei discorsi politici e in ambito accademico.	OBJ
publius48	OBJ
Nessundorma	OBJ
Tempo al tempo vedremo.	OBJ
E' solo molto più comodo da raggiungere (da Milano) che non Campiglio, che comunque è rimasto dieci volte più bello.	SUBJ
Nelle dolomiti c'è posto per tutti.	OBJ
Non siamo mai contenti	SUBJ
L'ostentazione della burineria e servizi montani penosi.	SUBJ
Il progetto Openpolis ha pubblicato nuovi dati sullo stato di attuazione del Piano Nazionale di Ripresa e Resilienza, il grande piano di riforme e investimenti da realizzare entro giugno del 2026 finanziato coi fondi europei, di cui lItalia beneficia nel complesso per oltre 194 miliardi di euro:	OBJ
Poi il leader M5S è durissimo con il ministro Nordio:	OBJ
Conte infanga Meloni?	SUBJ
Ed è proprio la Leonardo che, insieme ad Ansaldo Nucleare ed ENEL, partecipa alla nuova cordata italiana per il nucleare, promossa proprio in questi mesi.	OBJ
Il Repower-EU ha provato a tracciare la rotta in merito all’indipendenza energetica, che tutto è tranne che autosufficienza dell’UE.	SUBJ
Quello di cui c’è davvero bisogno è di una radicale riflessione sulla strada verso cui le classi dirigenti europee e occidentali ci stanno trascinando nella direzione di un baratro ambientale, sociale e militare.	SUBJ
LItalia ha speso meno di un terzo dei fondi del PNRR	OBJ
anbingrui	OBJ
risorse scartate da svariate riduzioni di budget relative ai progetti degli anni scorsi, da spendere necessariamente entro i prossimi due anni.	OBJ
"Non è stato un passacarte, è stato fino in fondo un'autorità politica""."	SUBJ
Una possibile soluzione, e attuabile nell’immediato, è quella proposta dall’economista Gabriel Zucman.	OBJ
Tra questi i titoli di Stato dei paesi più solidi, con Treasury e Bund (ma anche i Btp).	OBJ
Capisco il senso di appartenenza... ma addirittura masochisti purché sia di Destra,	SUBJ
In questi anni ci siamo battuti contro gli striscianti tentativi di riavviare nel nostro Paese un percorso di ritorno all’energia da fissione nucleare, una fonte insostenibile sotto tutti i punti di vista, la fantomatica quarta generazione – pur efficientando alcuni aspetti delle esperienze precedenti – non supera i problemi già noti e su cui in ben due occasioni in Italia ha vinto un forte “NO” referendario.	SUBJ
Roberta De Zanna, consigliera d’opposizione di Cortina Bene Comune, replica allarmata:	OBJ
L’associazione automobilistica tedesca Vda ha affermato che i dazi potrebbero avere ripercussioni sui posti di lavoro in Germania e in Europa.	OBJ
Sul versante Scuola, università e ricerca si arriva al 26,21 per cento (7,4 miliardi), ma il dato scivola al 14,79 per cento quando si parla di Salute, in cui sono stati spesi solo 2,3 miliardi su 15,6.	OBJ
Disse che a sua madre capita spesso di incontrare agli sportelli degli uffici pubblici impiegati e impiegate che tendono a darle automaticamente del tu, appena leggono e riconoscono come non italiani il nome e il cognome sui suoi documenti.	OBJ
Sarà la più moderna pista dEuropa, forse la più veloce, lunica senza lincubo dellammoniaca.	SUBJ
MAMO101	OBJ
A riportarlo è Openpolis, fondazione indipendente che da tempo monitora l'andamento dei progetti legati al Pnrr, raccogliendo in uno specifico portale (OpenPnrr) i dati che periodicamente vengono inseriti sulla piattaforma governativa Italia Domani.	OBJ
al 13 dicembre 2024 ne aveva spesi solo 58 miliardi, allincirca il 30 per cento del totale.	OBJ
Ma setacciando fra i vari settori di investimento, la spesa effettiva rilevata è ben più bassa.	OBJ
A Cortina andai due anni per amici in loco, scappato per sempre.	OBJ
Ma per il bob si spendono due milioni di euro a testa per i cinquanta atleti italiani che lo praticano.	OBJ
Secondo il monitoraggio di Openpolis i progetti più indietro sul fronte della spesa riguardano la transizione ecologica, con solo l’8 per cento dei fondi spesi contro l’85 per cento delle riforme attuate, la cultura e il turismo, per cui è stato speso l’11 per cento dei fondi a fronte di riforme completate, e la salute, con una spesa del 14 per cento dei fondi a fronte di tutte le riforme completate.	OBJ
"il fatto che esistano ""posti per ricchi""?"	OBJ
Si smonta qui definitivamente la narrazione per cui le scelte energetiche possono essere frutto esclusivo di valutazioni “tecniche” e non politiche.	SUBJ
@779 le dolomiti del Brenta la sera con sole che scende in fondo alla val Rendena crea un tramonto montano rosa ed arancione che non ha eguali al mondo.	OBJ
Il portavoce di Meta non ha detto in che modo è stato determinato che la responsabile degli attacchi fosse proprio Paragon, ma ha detto di aver inviato una lettera di diffida allazienda e di aver collaborato con le forze dellordine e con il laboratorio di ricerca canadese Citizen Lab, specializzato nellintersezione tra sorveglianza digitale e diritti umani.	OBJ
Non se be oarla sono la naggioranza degli elettori, ben protetti dal governo di cdx della Meloni che gli permetto di evadere ancora meglio!	SUBJ
L'aumento del dollaro ha fanno uno sgambetto all'oro, in calo anche se marginale, dopo che settimana scorsa aveva toccato i nuovi massimi storici.	OBJ
Il presidente Donald Trump ha inoltre fatto intendere chiaramente che lUnione Europea sarà la prossima presa di mira, citando un grande deficit commerciale con il blocco.	OBJ
Una tendenza a usarlo con eccessiva disinvoltura, a non alternarlo con il lei in modo appropriato e a trascurare modalità più formali di relazione potrebbe tuttavia aumentare il rischio di non rispettare la sensibilità e l’individualità dei parlanti.	SUBJ
Sarebbe inaccettabile, per esempio, una convenzione che imponesse alle donne di rivolgersi agli uomini con rispetto, e agli uomini di chiamare le donne per nome.	SUBJ
Dare del tu e chiamarsi per nome, a seconda del contesto, della relazione esistente tra i parlanti, e di molti altri fattori variabili, possono essere un modo per esprimere empatia oppure un modo di interloquire inappropriato e irrispettoso.	SUBJ
Poi fatte le olimpiadi verrà abbondonata.	OBJ
Si tratta di un contributo consistente, ma non essenziale:	SUBJ
Meno di 100 anni fa, le donne non potevano votare, e sembrava normale, nello stesso modo in cui oggi sembra normale vedere un autobus nel traffico.	SUBJ
In questo quadro di competizione e guerra che coinvolge innanzitutto il mercato energetico, la narrazione Italiana costruita dal Governo Meloni sulla “sicurezza energetica” si inserisce perfettamente.	SUBJ
E' quindi ipotizzabile che si assista a una fase in cui oro e dollaro si muovono nella stessa direzione, senza necessariamente influenzarsi a vicenda.	SUBJ
Per evitare di sembrare discriminatoria gli ha quindi chiesto:	OBJ
Cortina è sempre stato un posto per ricchi, o vogliamo cadere dal pero per fare polemiche tanto inutili quanto sterili?	SUBJ
La maggior parte dei cittadini e delle società svizzere non ha niente da perdere dalla totale trasparenza finanziaria e di certo preferirebbe la fine dell’evasione fiscale offshore alle costanti critiche al proprio Paese.	SUBJ
Per esempio, ad Amsterdam, più del 30% della popolazione usa biciclette, nonostante il fatto che l’Olanda abbia un reddito pro capite più alto di quello degli Stati Uniti.	OBJ
"""Sappiate che quando manca la politica i magistrati si prendono quello spazio e vogliono governare, accade da trent’anni almeno"":"	OBJ
Tuttavia, questa relazione si è notevolmente attenuata.	OBJ
Nelle caselle di testo sui siti, inclusi quelli istituzionali, c’è scritto «cerca», per esempio, o «compila qui».	OBJ
L’attitudine a darsi del tu e chiamarsi per nome più spesso che in passato non implica che sia sempre appropriato e inoffensivo farlo	SUBJ
La spesa che non c'è	OBJ
Saranno contenti gli italiani seguaci devoti di Trump.	SUBJ
Il sindaco Gianluca Lorenzi (domani a Milano per la festa dei -365 giorni alle Olimpiadi) si toglie un sassolino dalla scarpa («Tutti esaltavano il ghiaccio naturale di St. Moritz e volevano spostare i Giochi lì, ma la prova di Coppa del Mondo è stata appena cancellata per il caldo») e poi delinea un cronoprogramma super ambizioso:	OBJ
Capisco le polemiche, i soldi in gioco sono tanti, ma se c’è un luogo nelle Alpi che merita una pista è Cortina con i suoi cent’anni di tradizione bobbistica».	OBJ
Cripto allo sbando, Ethereum fino a -27%	OBJ
quando il dollaro si rafforza, loro tende a indebolirsi.	OBJ
C’è molto da fare, molto da cambiare, soprattutto nella testa della gente.	SUBJ
Sarebbe quindi una coalizione contro cui la Svizzera non avrebbe interesse a combattere.	SUBJ
Cortesia e rispetto sono qualità umane che si manifestano nei rapporti interpersonali in molti modi diversi.	OBJ
L’uso del tu reciproco è da tempo diffuso tra persone sconosciute:	OBJ
Homo Habilis	OBJ
Al contrario l’attuazione del piano in termini di obiettivi raggiunti, come l’avvio dei progetti e delle riforme previste, è molto più avanti:	OBJ
l’offerta di Lake Placid che aveva ingolosito il Cio e umiliato noi italiani (viaggi e alberghi per gli Usa regalati dagli zii d’America, premiazione a New York) è respinta al mittente, i Giochi 2026 saranno tutti tricolori.	SUBJ
Il fronte delle opposizioni va durissimo all'attacco della premier Giorgia Meloni e del governo nel dibattito alla Camera dopo le informative dei ministri Carlo Nordio e Matteo Piantedosi sul caso Almasri.	OBJ
al posto della lira io sceglierei l'arpa	OBJ
La verità è che vi vergognate di quello che fate e per questo mentite.	SUBJ
Purtroppo lo stesso non si può dire per le facility per gli sport invernali ed estivi.	OBJ
Ricordiamo che Leonardo è l’azienda che più di tutte ha visto lievitare il proprio fatturato dall’escalation in Ucraina fino ad arrivare al genocidio a Gaza e l’allargamento del conflitto a tutto il Medio Oriente.	SUBJ
Il mercato crypto paga anche la mancanza di misure immediate per sostenere il settore.	OBJ
Internet, gli smartphone, gli assistenti vocali e altri progressi hanno reso la comunicazione più “orizzontale” e accessibile di quanto lo fosse prima.	SUBJ
Chi le ha chiesto di stare fermo?	OBJ
CONTE - Come Schlein, anche Giuseppe Conte parte subito all'attacco della premier Meloni assente in aula.	OBJ
"Questo cambiamento mette in discussione l’idea tradizionale che un dollaro forte penalizzi i metalli preziosi e viceversa""."	OBJ
Un caso a parte è il settore del Fisco e della revisione della spesa, che ad oggi conta il 45,45 per cento di interveti normativi effettuati e punta a raggiungere il 100 per cento entro il secondo trimestre del 2026.	OBJ
Prendono quasi niente e noi tutto, milioni di auto, enormi quantità di cibo e prodotti agricoli.	OBJ
Inoltre, ad oggi, i titoli di Stato hanno il vantaggio aggiuntivo di alti rendimenti.	OBJ
Le nostre indagini indicano che potresti aver ricevuto un file dannoso tramite WhatsApp e che lo spyware potrebbe aver comportato laccesso ai tuoi dati, inclusi i messaggi salvati nel dispositivo».	OBJ
"E se come dice"" la sorella della premier, Arianna, ""sua sorella è Frodo, l'anello del potere l'ha già indossato e le ha dato alla testa e ha liberato Sauron Almasri, che è capo di un battaglione di orchi torturatori di bambini in Libia""."	OBJ
Datevi da fare a stanarli, quindi!	SUBJ
In particolare Volkswagen e Stellantis son o arrivati a cedere il 7% in Borsa.	OBJ
Direi lungimirante.	SUBJ
Grazie a soluzioni tecnologiche innovative è possibile gestire il servizio, dalla prenotazione al rilascio dell’auto, tramite un’applicazione mobile.	OBJ
"""La nostra credibilità internazionale -rimarca la segretaria del Pd- è stata sfregiata dalla vostra scelta, oggi rivendicata, di riaccompagnare a casa un torturatore libico Almasri è accusato di aver picchiato, stuprato e ucciso, ma nonostante questo viene scarcerato e fatto salire su un aereo di Stato con tutti gli onori, per poi essere accolto nel suo paese come un eroe."	OBJ
Pichetto-Fratin, ministro della Sicurezza Energetica annuncia limminente arrivo del disegno di legge sul nucleare in Consiglio dei Ministri.	OBJ
Al momento non si sa quali governi siano responsabili delle attività di spionaggio.	OBJ
A far scalpore è il crollo dell'Ethereum, seconda criptovaluta per capitalizzazione di mercato, arrivata fino a -27%.	OBJ
Adesso non si torna più indietro:	OBJ
In aula sono intervenuti Elly Schlein, Giuseppe Conte, Ettore Rosato, Maria Elena Boschi, Nicola Fratoianni e Riccardo Magi.	OBJ
No continua alla grande.	SUBJ
Evviva la repubblica Italiana degli evasori	SUBJ
Non esiste “uguaglianza democratica”.	SUBJ
In qualche modo il car sharing ha anticipato la cosa.	OBJ
Anche per effetto dellinfluenza dellinglese, il tu e i verbi alla seconda persona singolare sono da sempre le forme dominanti dellitaliano su Internet e nei contesti digitali.	OBJ
No meglio prenderlo..... sorrdidendo :)	SUBJ
A proposito di queste cifre, sono necessarie due osservazioni.	OBJ
Tra le valute il dollaro Usa si è rafforzato notevolmente sulla scia di aspettative di crescita globale inferiori e potenzialmente meno spazio per la Fed per tagliare i tassi.	OBJ
Che problema è?	OBJ
«Grazie per non avermi parlato come se fossi un vucumprà».	SUBJ
Prima con Tangentopoli poi con i governi Berlusconi.	SUBJ
In italiano, tralasciando i casi in cui la preferenza per i pronomi di cortesia è espressa minacciosamente per reclamare deferenza e spesso per cambiare argomento («lei non sa chi sono io!»), è comunque consigliabile non abusare del tu in situazioni formali.	OBJ
Schlein ribatte all'informativa del ministro Nordio e lo accusa:	OBJ
«Insomma, ho solo sbagliato aggiungendo linglese, che non serviva, ma il mio lei lo ha fatto sentire rispettato.	SUBJ
La grande ineguaglianza nei paesi in via di sviluppo rende difficile vedere, per esempio, che in termini di trasporto, una città evoluta non è quella in cui anche i poveri usano le automobili, ma piuttosto quella in cui anche i ricchi usano il trasporto pubblico.	SUBJ
Lo stesso approccio permetterebbe di ottenere la collaborazione di altri centri importanti.	OBJ
I ministri sono in aula a coprire le spalle della presidente del Consiglio.	OBJ
Tramite un software israeliano in una ventina di paesi, compresa l’Italia	OBJ
Ma guardate, è così dalla caduta della prima Repubblica nel 1992-94.	SUBJ
Capita spesso con le giovani donne vittime di femminicidio, per suggerire una condizione di vulnerabilità e fragilità, ma anche con giovani uomini, alludendo alla loro inesperienza.	OBJ
se avesse firmato lei l'atto e il presidente del Consiglio avesse fatto un video attaccandola, come si sarebbe sentito?	OBJ
Circa l’8% dei patrimoni finanziari mondiali è detenuto nei paradisi fiscali, e nei paesi emergenti e in via di sviluppo la percentuale aumenta notevolmente (30% Africa, oltre il 50% in Medio Oriente).	OBJ
"E' da quel momento, secondo lui, che ""la magistratura tende a occupare, e in parte ci è riuscita, gli spazi di competenza della politica."	SUBJ
Sotto quella legislatura è diventata pressante a tutti i livelli la propaganda per il ritorno al nucleare, dalle dichiarazioni istituzionali, alle campagne giornalistiche e social, alle iniziative “divulgative” messe in campo da una serie di attori privati del settore che hanno tutto l’interesse ad ampliare all’Italia il mercato per le loro tecnologie.	SUBJ
E quale sarebbe il problema se cortina diventa sempre più un posto per ricchi?	SUBJ
«Se il pronome preferito di una mia studentessa fosse “Sua Altezza Reale”, non sarei in alcun modo obbligato a rivolgermi a lei in quel modo», a meno che non fosse effettivamente una principessa in qualche famiglia reale, ha scritto Benatar.	OBJ
E questo capita indipendentemente dalleventuale familiarità tra i due, o dalla rispettiva appartenenza politica.	OBJ
Negli ultimi anni è capitato però che gli spyware venissero installati anche sui dispositivi di decine di giornalisti, attivisti, funzionari di altri governi e politici dopposizione:	OBJ
L'annuncio di sabato che Washington avrebbe applicato dazi al 25% contro Messico e Canada, e al 10% sulla Cina, a partire da martedì è stata una sorpresa per i mercati.	OBJ
Se non veniva fatta la colpa serebbe stata di un	OBJ
Il numero di veicoli elettrici è passato da 620 mezzi nel 2015 ai 2,200 del 2017.	OBJ
«Caro compagno, dammi pure del lei».	SUBJ
Prima di fasciarti la testa aspetta di vedere come si svilupperanno gli eventi.	SUBJ
Ligera	OBJ
"Come dice la premier, se qualcuno oggi vuole governare si deve candidare e non cercare altre strade""."	OBJ
I banchieri hanno però un’influenza politica che supera di gran lunga il loro reale peso economico e quindi, senza minacce di rappresaglie, c’è da temere che riusciranno a mantenere una forma di status quo – a costo di abbandonare una parte della loro clientela, cioè quella che non ha i mezzi per nascondere i propri attivi nei trust, concentrandosi invece sulle fortune più ingenti.	SUBJ
Il signore le ha quindi risposto, con un gran sorriso e con dizione in perfetto italiano:	OBJ
E ha poi aggiunto:	OBJ
Una vergogna ai miei occhi!	SUBJ
sono passati più di tre anni e mezzo dallapprovazione, avvenuta nellestate del 2021, e manca solo un anno e mezzo alla scadenza, fissata per metà del 2026.	OBJ
I due asset sono inversamente correlati in quanto l'oro è quotato in dollari Usa, quindi quando il biglietto verde si rafforza, l'oro diventa più costoso al di fuori degli Stati Uniti e la domanda (e quindi il prezzo) diminuisce.	OBJ
Con ogni probabilità, una perdita di 15 miliardi di euro sarebbe sufficiente per convincere la Svizzera a una cooperazione reale, perché la somma è paragonabile a quello che il Paese guadagna in totale gestendo i patrimoni degli evasori fiscali.	SUBJ
È probabile che Citizen Lab pubblicherà un rapporto in cui fornisce maggiori dettagli sugli obiettivi della campagna di spionaggio, come ha fatto in passato con altri casi.	OBJ
"""Lei oggi è stato scandaloso."	SUBJ
Nel 2016 sono stati effettuati complessivamente circa 8 milioni di noleggi per una percorrenza complessiva di 62 milioni di km.	OBJ
Prendiamo il caso della Svizzera  ma lesempio potrebbe applicarsi a Dubai, Macau o qualsiasi altro Paese tentato di fare nel XXI secolo quello che la Svizzera ha fatto per la prima volta nel XX, cioè aiutare i frodatori a sottrarsi alle leggi dei loro Paesi dorigine.	SUBJ
"Per Schelin oggi il governo si è nascosto ""dietro i cavilli e il giuridichese, ma qua non si tratta di un difesa formale, ma di una scelta politica."	SUBJ
Volkswagen ha in Messico uno dei suoi più grandi stabilimenti e ieri si è premurata di auspicare «colloqui costruttivi» per preservare la stabilità economica.	OBJ
Siccome non siamo in un regime comunista, allora è bello che ci siano posti per soli ricchi e posti per soli poveri, tutti però a spese della collettività.	SUBJ
La percentuale di completamento è al 79,54 per cento, e si prevede che possa raggiungere l'85,2 per cento entro la fine del trimestre attualmente in corso.	OBJ
Il secondo mandato di von der Leyen farà capire se l’Unione ha forza e volontà per difendere le regole con cui ha normato il digitale e le sue mostruose concentrazioni.	SUBJ
Recentemente lo stesso ufficio ha poi condotto uno studio sullo stato di realizzazione di uno degli obiettivi più discussi e ambiziosi del piano, cioè la realizzazione di nuovi posti negli asili nido e nelle scuole materne, da sempre una delle grosse criticità delle politiche familiari italiane:	OBJ
Siamo così abituati alla diseguaglianza che a volte è davanti al nostro naso e non la vediamo.	SUBJ
Appena il 30,14 per cento dei 194,4 miliardi stanziati complessivamente.	OBJ
Ma così Cortina sarà sempre più un posto per ricchi	SUBJ
Cinquanta?	OBJ
La percentuale cala al 22,61 per cento per i progetti di Digitalizzazione, pari a 3 miliardi dei 13 disponibili, nonostante abbia già raggiunto il 100 per cento delle riforme normative da attuare.	OBJ
Fino a venerdì pomeriggio infatti circolavano voci secondo cui il primo round di dazi sarebbe partito il 1° marzo, dando così a Canada e Messico un mese per negoziare.	OBJ
Google ha respinto lidea del fact checking su YouTube.	OBJ
La questione deve essere posta al centro del dibattito sul commercio.	OBJ
La prospettiva di un mondo in cui non si studiano più le lingue straniere	SUBJ
Ma se le minacce non dovessero risultare sufficienti, dovranno trasformarsi in realtà.	OBJ
Giornata decisamente difficile per il settore auto, tra quelli potenzialmente più impattati dai dazi.	SUBJ
Lunedì molto difficile per le criptovalute in quanto l'attrattiva degli asset più rischiosi è intaccata dalle crescenti tensioni sui dazi.	OBJ
È un principio molto forte.	SUBJ
Le automobili sono distribuite a rete all’interno di un territorio e possono essere prelevate automaticamente senza bisogno di assistenza da parte di personale.	OBJ
"""Torsione autoritaria"":"	OBJ
Spriamo di no.	SUBJ
una guerra economica si concluderebbe di certo con la sconfitta di Berna.	SUBJ
10 a zero G25	OBJ
L’efficacia di questi software dipende dallo specifico programma, ma ne esistono di molto potenti, capaci di raccogliere email, elenchi di contatti, registrazioni audio, immagini, video e password, ma anche di attivare telecamere e microfoni per registrare ciò che sta accadendo attorno al dispositivo, ascoltarne le chiamate e registrarne la posizione senza che il proprietario se ne accorga.	OBJ
A parte gli allocutivi, ci sono altri modi di esprimere cortesia in italiano neostandard, definizione proposta nel 1987 dal sociolinguista Gaetano Berruto per una varietà di italiano informale parlata dalla maggior parte della popolazione e diversa da quella imparata a scuola.	OBJ
Vediamo la proposta di seguito nel dettaglio:	OBJ
Meglio un posto per pochi alcuni dei quali si faranno solo una settimana di vacanza all'anno, ma come si deve e non in stile coatto a Roccaraso.	SUBJ
Lo stesso Ufficio Parlamentare di Bilancio ha fatto notare a sua volta i ritardi nella spesa:	OBJ
Sono lieto che la pista sia terminata per tempo.	SUBJ
15 miliardi di euro è la somma che potrebbero recuperare con un dazio del 30% sulle merci provenienti dalla Svizzera.	OBJ
Gaspareconsiglia	OBJ
"Cosa dicono i sondaggi riservati"":"	OBJ
Il lei serve anche a rispettare le diverse sensibilità e proteggere le individualità delle persone, specialmente quelle che non conosciamo, perché «a volte consente di avvicinarsi piano piano all’interlocutore e capire quale livello di formalità la persona gradisce».	SUBJ
Si tratta da un lato di una scelta di campo:	OBJ
Eppure i progetti sono spesso a buon punto e molte riforme sono state avviate:	OBJ
Spiritolibero	OBJ
"Meloni diceva che avrebbe dato la caccia ai trafficanti di tutto il mondo, invece li rimanda a casa con il rimpatrio più veloce della storia""."	OBJ
La prima virata a monte, la Curva Sento, è completa, la Bandion è armata, l’«otto» tra Antelao e Cristallo impostato.	SUBJ
Cose le hanno fatto i magistrati....	OBJ
Dare del tu a una persona che presumiamo essere migrante o straniera è una scelta probabilmente motivata dalla convinzione che quella persona non comprenda bene l’italiano.	OBJ
Poi che andare a Cortina specialmente a Natale sia diventato un po' come affacciarsi al circo Barnum è la verità , però se ci si va in periodi diversi le montagne intorno sono splendide.	SUBJ
Oddio credevo venticinqe.	OBJ
Il tuo commento........concordo.	SUBJ
Lettore_15054040	OBJ
Si mormora sopratutto di partnership già avviata con i Giochi 2030 in Francia.	OBJ
Gli economisti ipotizzano infatti che i dazi potrebbero causare una nuovo fiammata dell'inflazione e crescita più debole negli Stati Uniti, e potenzialmente alimentare recessioni in Canada e Messico, due paesi che hanno forti relazioni commerciali con la maggiore economia al mondo.	OBJ
Paragon negli anni ha cercato di posizionarsi come un operatore più virtuoso degli altri, vantandosi per esempio di lavorare solo con paesi democratici e con governi stabili, e di non vendere Graphite ai governi di paesi democratici che sono noti per aver abusato di spyware in passato, tra cui Grecia, Polonia, Messico e Ungheria.	OBJ
Ecco ad esempio che la Regione Liguria, guidata dalla destra, ha pensato bene di stanziare 220mila euro per un progetto di educazione allaffettività nelle parrocchie e negli oratori.	OBJ
Commento fantastico..	SUBJ
Quel giorno passeremo dall’acquistare un mezzo ad acquistare mobilità.	OBJ
“Circa il prolungamento del Pnrr nel 2026 ho già detto che noi non chiediamo proroghe perché è evidente che avevamo assunto degli impegni e dobbiamo essere coerenti con gli impegni che abbiamo assunto” ha detto il ministro degli Affari europei, Tommaso Foti.	OBJ
Ma chi ha accettato queste olimpiadi	OBJ
Ricordiamo come già nel 2021, nel corso delle discussioni al Parlamento europeo sugli atti delegati al Green Deal, il nucleare da fissione era stato presentato insieme al gas come fonte “di transizione”.	OBJ
Una politica onesta, pulita e trasparente.	SUBJ
Poiché i dazi-sanzioni sono realistici e proporzionati, e pertanto credibili, in teoria non dovranno essere applicati.	SUBJ
Contestano l'assenza della premier e contestano il merito delle informative che non chiariscono affatto, sostengono le opposizioni, perchè l'esecutivo abbia rilasciato e riaccompagnato in Libia con volo di Stato un ricercato dalla Corte penale internazionale per crimini contro l'umanità.	OBJ
Lettore_17132480	OBJ
Tutti i problemi derivanti dal traffico deviano tanti soldi in nuove strade, lotta all’inquinamento, sanità dovuta allo smog, ecc.	OBJ
Stiamo parlando di minacce da brandire, che auspicabilmente non dovranno essere messe in pratica.	SUBJ
fa la vittima.	OBJ
Nicolò Zanon smonta le toghe anti-Meloni, perché sbagliano	OBJ
Lo stesso Trump, dopo una telefonata con Tim Cook (ceo Apple) ha detto:	OBJ
"""Questa è una giornata triste per la democrazia."	SUBJ
Rispetto a vent’anni fa, per esempio, la frequenza di utilizzo di Mr e Mrs è diminuita del 30 e del 56 per cento.	OBJ
Lettore_15653544	OBJ
Se cerchiamo di applicare questo principio democratico per cui il bene pubblico prevale sull’interesse privato, un autobus con 100 persone ha un diritto allo spazio pubblico 100 volte superiore a quello di una sola macchina.	SUBJ
Sulla neve, in un viavai ininterrotto di camion e operai dalle 7 alle 19, festivi compresi, ci sono decine di enormi cilindri neri serviti al trasporto del liquido refrigerante, l’acqua glicolata.	OBJ
Io sono di Courmayeur.	OBJ
«A dicembre WhatsApp ha interrotto le attività di una società di spyware che riteniamo abbia attaccato il tuo dispositivo.	OBJ
Non possiamo ancora fare delle valitazioni serie.	SUBJ
è stato il giudice assolutore.	OBJ
Quelli più avanti riguardano le infrastrutture, per cui è stato speso il 46 per cento dei fondi, e le imprese, con il 47 per cento.	OBJ
Nello Musumeci, ministro della Protezione civile nonché esponente di FdI, lo ha detto in un'intervista a Repubblica a proposito dello scontro politica-magistratura.	OBJ
In generale, negli ultimi decenni, l’uso di formule un tempo riservate soltanto ai rapporti informali – di parentela, di amicizia, di lavoro – si è esteso a situazioni in cui in passato non era ammesso.	OBJ
Secondo le statistiche ufficiali, l’industria finanziaria costituisce circa l’11% del Pil elvetico.	OBJ
Lettore_2418318	OBJ
«Non permetterò che approfittino delle nostre aziende».	SUBJ
Un signore guardava spaesato il tabellone degli orari sul suo stesso binario.	OBJ
Dopo aver notato che aveva forse bisogno di aiuto, e aver registrato mentalmente altre informazioni (era una persona nera, «vestita in modo sobrio e pulito»), nel proporre aiuto Molinelli si è chiesta se usare il tu o il lei, nel dubbio che lui potesse non capire l’italiano.	OBJ
Nell’ultima relazione al parlamento, avvenuta a luglio dello scorso anno, il governo puntò molto proprio su questo:	OBJ
Non è stato qui il difensore di Almasri, ma peggio:	OBJ
La funzione, all’epoca, era stata quella di accontentare Francia e Germania in un momento in cui la transizione avrebbe significato per la Germania smantellare l’ingente quantitativo di centrali a carbone passando al gas (era infatti pronto il North-Stream II, per un approvvigionamento diretto dalla Russia);	OBJ
Uno dei tanti modi, per esempio, è il cosiddetto imperfetto attenuativo (o di cortesia, appunto), usato per attenuare richieste che all’indicativo suonerebbero impositive («Buongiorno, volevo un’informazione su…»), o anche per smorzare l’urgenza di una comunicazione («Volevo dirvi che…»).	OBJ
Elly Schlein definisce così la premier Meloni che le opposizioni continuano a chiamare in aula.	OBJ
CitizEUn	OBJ
Nel Nord del paese molti docenti e ricercatori usano il tu reciproco, mentre al Sud e nelle isole c’è ancora un’attenzione maggiore ai ruoli accademici, e di conseguenza più formalità:	OBJ
Lettore_14157448	OBJ
Lettore_17998019	OBJ
la pista, il biscione di ferro e acciaio di 1.650 metri e 16 curve dei Giochi 2026, è quasi pronta.	SUBJ
DI bello i comuni hanno poco nulla tra l'altro si cammina in stradine dove il sole arriva poco.	OBJ
Nel lungo periodo, il libero scambio è vantaggioso per tutti e il protezionismo deve essere evitato, ma, molto semplicemente, non possiamo continuare a liberalizzare i mercati ignorando il problema della dissimulazione fiscale.	SUBJ
Anche l’inglese, secondo diverse ricerche, è diventato più informale che in passato:	OBJ
Questo sistema sta funzionando alla grande e, per esempio, in Guangzhou gli autobus trasportano più passeggeri di tutte le linee della metropolitana cinese, ad una frazione del prezzo.	OBJ
A cento metri di quota, le Tofane maestose a destra, il Cristallo a sinistra, metabolizzato un anno di «niet» dell’appaltatrice Simico a chi voleva verificare l’avanzamento dei lavori e incassati i dubbi rabbiosi espressi dal Cio sul comitato organizzatore (con il famoso piano B sempre incombente), un fatto è lampante:	SUBJ
Cosa ne sarà dopo i Giochi?	OBJ
Rispettare pienamente il linguaggio della cortesia, scrive Coluccia, richiede però anche la capacità di variare tra il tu e il lei in un modo appropriato alle diverse situazioni comunicative.	OBJ
fissato il telaio di supporto, modellate le gabbie delle curve, montata la rete di tubi dove scorre il glicole, si arma la struttura spruzzando cemento speciale che resiste a congelamento e scongelamento.	OBJ
Secondo lui la non reciprocità di certe forme di cortesia non è una cosa sbagliata in sé:	SUBJ
In salita invece il prezzo del petrolio (+2%) perché gli investitori ritengono che i dazi potessero interrompere le forniture agli Stati Uniti, il più grande consumatore di greggio al mondo.	OBJ
Lofferta di Lake Placid che aveva ingolosito il Cio è respinta al mittente.	OBJ
Primo, la perdita di gettito fiscale dovuta al segreto finanziario è stimata al minimo, perché non include il costo degli scudi fiscali che gli Stati hanno dovuto approvare per paura che i loro contribuenti nascondessero i propri soldi in Svizzera.	OBJ
I lavori accessori cominceranno subito».	OBJ
WhatsApp dice che oltre novanta giornalisti e attivisti sono stati spiati sulla sua app	OBJ
Il Bitcoin, il token digitale più grande, è sceso al minimo delle ultime tre settimane in area 94mila dollari, ossia ben 15mila sotto i massimi storici toccati lo scorso mese.	OBJ
E finalmente soluzioni nuove cominciano a vedersi.	SUBJ
L’azienda, fondata dall’ex primo ministro israeliano Ehud Barak, è stata recentemente venduta a una società di private equity statunitense, AE Industrial Partners, per 900 milioni di dollari.	OBJ
May I help you?».	OBJ
Lombra dei duemila larici che sostituiscono i mille centenari abbattuti arriverà tra decenni, la spesa (85 milioni di euro, Iva esclusa) copre solo il tracciato, di parcheggi (qui merce rarissima e carissima), tribune, accesso del pubblico a unarea impervia non parla nessuno come pure del futuro di un impianto in unItalia che vanta solo cento tra bobbisti e slittinisti agonisti in uno sport che per il Cio non ha futuro.	OBJ
È sbagliato semmai quando quelle differenze di potere nella società sono distribuite sulla base di criteri inaccettabili.	SUBJ
Resti pure un posto per ricchi:	SUBJ
già nel 2019, per esempio, WhatsApp aveva fatto causa all’azienda israeliana NSO Group per aver sfruttato una falla di sicurezza nel proprio codice per spiarne gli utenti.	OBJ
Ma non si vergogna?	OBJ
Il dato ancor più positivo è che la maggior parte dei servizi di mobilità condivisa è a Zero Emissioni.	SUBJ
"Non si capisce la relazione yra pista da bob e ""ricchi"", quelli al più sciano mica fanno il bob o lo skeleton."	OBJ
Lo spyware di Paragon, Graphite, funziona in modo piuttosto simile a quello di NSO.	OBJ
Openpolis ha detto che arrivare a questi calcoli non è stato facile, a causa dei ritardi e delle opacità nella pubblicazione dei dati da parte di Italia	OBJ
Titoli auto UE nel mirino, Stellantis -7%	OBJ
Molinelli cita un esempio che le è capitato pochi giorni fa, in una grande stazione ferroviaria a Milano.	OBJ
Come era facile prevedere, la marcia indietro del Governo sui fondi destinati inizialmente all’educazione all’affettività e alla sessualità, sta iniziando a dare i temuti risultati.	SUBJ
Lettore_2814779	OBJ
Nel frattempo abbiamo tagliato alberi e sfrattato il parco avventura.	OBJ
Commentando l'iscrizione nel registro degli indagati della premier Giorgia Meloni, dei ministri Nordio e Piantedosi e del sottosegretario Mantovano per il caso del generale libico Almasri, Musumeci ha sottolineato:	OBJ
Giù anche l'oro, asset rifugio per eccellenza.	OBJ
"larga fetta dei ""ricchi"" son EVASORI."	SUBJ
Hai ragione quasi su tutto, Cortina non conosco, ma Curma è diventato tutto meno che un posto ben frequentato, caro si, ma senza servizi e piste decenti e poco sole in paese.	SUBJ
Sia chiaro:	SUBJ
Il gruppo è anche incaricato di esaminare la creazione di una riserva di bitcoin, uno dei punti focali per il settore.	OBJ
"""Io penso che non sia corretto che un pm prende una denuncia di otto righe e questa si trasforma in un atto d'accusa verso il premier e i ministri."	SUBJ
"La capisco la nostra premier, era assai difficile, forse impossibile venire qui a schiena dritta a giustificare la scelta del suo governo di liberare un torturatore, uno stupratore di bambini, per questo ha inviato qui due onorevoli prestanome""."	SUBJ
Termine che, tuttavia, non sembra preoccupare troppo l'esecutivo:	OBJ
Spianato in tempo record da FdI	OBJ
significa che i ritardi e i problemi del piano riguardano la capacità di spesa dei diversi enti che gestiscono i programmi, cioè il finanziamento concreto dei progetti (che hanno poi ricadute sull’economia nazionale).	SUBJ
"Ma la vittima non è la presidente del Consiglio, le vittime qui sono i torturati da Almasri, le donne e i bambini torturati, ma tanto sono in Libia, non le vediamo, giusto?""."	SUBJ
Su 269.299 progetti monitorati, l'ammontare della spesa effettiva va ancora a rilento dopo tre anni e mezzo dall’approvazione del Piano (nel luglio 2021) e a meno di due anni dalla sua conclusione, prevista per il 30 giugno 2026.	OBJ
per rimanere sempre all'ultima moda imperante	SUBJ
In ogni caso, senza minacce specifiche non si faranno progressi.	OBJ
Stacchiamo la spina a questo sistema!	SUBJ
Questi tre Paesi possiedono in totale circa 500 miliardi di euro nelle banche svizzere, di cui grosso modo l’80% è ancora nascosto.	OBJ
Ma la buona notizia è che basterebbe un piccolo gruppo (la Francia, la Germania e l’Italia o il Regno Unito) per obbligare le banche e le autorità svizzere a una completa cooperazione.	OBJ
Il numero di veicoli condivisi globalmente in Italia tra il 2013 e il 2017 è quintuplicato, mentre il numero degli iscritti e dei noleggi è cresciuto rispettivamente di diciotto e trentasette volte.	OBJ
«Posso aiutarla?	OBJ
Al 13 dicembre 2024, sono stati spesi 58,6 miliardi di euro di fondi del Piano nazionale di ripresa e resilienza.	OBJ
Cortina è un posto meraviglioso, direi unico in Italia.	SUBJ
Lo scopo di Leonardo è di agire in tutti i settori strategici della difesa (“multidominio interoperabile” lo definisce Cingolani), compreso quello energetico, relativo allo sviluppo del nucleare.	OBJ
Il governo Meloni, però, continua ad andare per la sua strada non perdendo i consensi.	OBJ
Poco in confronto ai paesi esteri, ma comunque un buon inizio.	SUBJ
Personalmente non sono d'accordo sui dazi, ma la settimana scorsa si è perso molto di più con un solo annuncio.	SUBJ
Non compreremo auto, ma abbonamenti che ci permettono di “muoverci”, usare questa o quel mezzo di trasporto, che sia pubblico o privato.	SUBJ
Ad oggi il 24% delle vetture noleggiate è a zero emissioni.	OBJ
Di che conflitti parlo?	OBJ
E' vero Cortina è sempre stato un posto per ricchi, che ultimamente si sono trasformati in ricchi burini.....	SUBJ
Lo stesso vale per l’uso del tu o del lei.	OBJ
