sentence	prediction
"وتأتي هذه الخطوة من الحكومة اللبنانية كجزء من جهودها لتقليص النفوذ الميليشياوي القديم ، كما صرح الباحث في شؤون الجماعات المتطرفة أحمد بان لسكاي نيوز عربية ،  إلى أن "" الدولة اللبنانية تعمل على أن تكون دولة مؤسسية تحترم علاقاتها مع الدول العربية ،  عن التأثير الإيراني ""."	OBJ
في الوقت نفسه ، سيظل التضخم  فوق 2 بالمئة ، الأمر الذي يحد من نطاق قدرة بنك إنكلترا على خفض أسعار الفائدة ، حيث تشعر الشركات بتأثيرات ارتفاع الضرائب.	OBJ
يستمر الذكاء الاصطناعي في تشكيل مستقبل القوى العاملة ، حيث  أن يكون له تأثير أكبر في العام 2025 ، فمع تصاعد الاعتماد على التكنولوجيا لتحسين الكفاءة وتقديم حلول مبتكرة ، تواجه سوق العمل تحولات ملحوظة تتطلب من الأفراد اكتساب مهارات جديدة للتكيف مع هذا التغير السريع.	OBJ
هذه التوجهات لن تقتصر على التغيرات في طريقة العمل فقط ، بل تشمل  تطور عادات المستهلكين واحتياجاتهم في ظل البيئة التكنولوجية المتنامية.	OBJ
في نفس الوقت ، يتوقع قادة بعض قادة التكنولوجيا أن تشهد ديناميكيات السوق  في 2025 نتيجة للتغيرات المستمرة في استخدام التكنولوجيا من قبل الشركات ، وهذه التغيرات قد تدفع الشركات نحو زيادة استثماراتها في الابتكار الرقمي لمواكبة احتياجات العملاء المتزايدة وتعزيز قدرتها التنافسية في أسواق تعتمد بشكل متزايد على التكنولوجيا.	OBJ
"تقرير  "" بيزنس إنسايدر "" يشير إلى أن المحادثات حول الذكاء الاصطناعي كانت تسيطر على العام 2024 ، ويتوقع قادة التكنولوجيا أن المرحلة التالية من عصر الذكاء الاصطناعي الجديد ستأتي في العام 2025 ، سواء للأفضل أو الأسوأ."	OBJ
بحسب فوغيلز ، فإن : تسخير التكنولوجيا لتحقيق الخير أصبح ضرورة أخلاقية  .	SUBJ
لكنه من ناحية أخرى ، يتوقع أن المستهلكين الآخرين سوف يشتروا أجهزة أكثر  ، مثل الروبوتات التي تطورها شركة تسلا وشركات الروبوتات الأخرى.	SUBJ
" : "" سيتم طلب ما لا يقل عن 100 ألف روبوت ذكاء اصطناعي شخصي  ""."	OBJ
ومعالجة هذه التحديات ستتطلب استراتيجيات مدروسة  من السياسات العامة.	SUBJ
وسيتعين على المزيد من الشركات تكييف استراتيجياتها  لانقطاعات سلسلة التوريد	SUBJ
"وكشف التقرير أن الأبحاث الحديثة أظهرت أن الاستخدامات الأكثر  لبرنامج الدردشة بالذكاء الاصطناعي "" Claude "" تركز على ثلاثة مجالات رئيسية هي ، تطوير تطبيقات الهواتف المحمولة ، إنشاء المحتوى والتواصل ، والبحث الأكاديمي والكتاب."	OBJ
فالأفراد باتوا يثقون  بتزويد نماذج مثل ChatGPT وGemini وCopilot وApple Intelligence ، وغيرها ببياناتهم الحساسة ، رغم أن هذه النماذج لديها سياسات خصوصية مختلفة تشمل إمكانية استخدام بيانات المستخدم والاحتفاظ بها.	OBJ
وفي الكثير من الحالات ، لا يدرك المستخدم هذا الأمر ، ليتبين له  أن خوارزميات الذكاء الاصطناعي كانت تتدرب على بياناته ، التي تم استخراجها دون نيل الموافقة الصريحة منه ، مما قد يؤدي إلى مجموعة متنوعة من التأثيرات السلبية عليه.	OBJ
"وتقول مستشارة الذكاء الاصطناعي المعتمدة من أكسفورد هيلدا معلوف ، في حديث لموقع "" اقتصاد سكاي نيوز عربية "" ، إنه في عالم يتسارع فيه إيقاع الحياة بشكل غير مسبوق ، بات الذكاء الاصطناعي التوليدي أشبه  "" الصديق الرقمي المثالي "" الذي يلجأ إليه الناس لمساعدتهم في اتخاذ قراراتهم اليومية ، ليتبين أن هذه التكنولوجيا لا تكتفي فقط بتقديم حلول  في أماكن العمل ، بل تتجاوز ذلك لتصبح   يفهم احتياجات المستخدمين ويواكب تفضيلاتهم في الحياة العادية."	OBJ
"وقالت : "" ينبغي الانتباه  إلى المعلومات التي نشاركها معه ، حيث من الأفضل عدم تزويد برامج الذكاء الاصطناعي بمعلومات مرتبطة بالتفاصيل المالية ، مثل أرقام الحسابات البنكية أو البطاقات الائتمانية ، وكلمات المرور ومعلومات سرية عن الوظيفة ، وتفاصيل الإقامة والبيانات الشخصية الأخرى ، فقد تؤدي مشاركة هذه المعلومات الحساسة إلى ظهورها على خوادم عامة ""."	OBJ
العوامل التي قادت هذا الأداء الضعيف تنوعت بين الضغوط الاقتصادية الناجمة عن تباطؤ النمو في الصين ، وتحديات تعافي الطلب بعد الجائحة ، علاوة على تأثير الإمدادات النفطية من خارج تحالف أوبك +  من الولايات المتحدة ودول أخرى.	OBJ
ومن بين العوامل المؤثرة  التي يشير إليها إسماعيل ما يتعلق بحجم الإنتاج من خارج أوبك ، من دول منتجة مثل كندا والبرازيل وغويانا ، وبما قد يسهم في إغراق سوق النفط.	OBJ
"ويتابع خبير اقتصاديات الطاقة في معرض حديثه مع موقع "" اقتصاد سكاي نيوز عربية "" ،  : اهتمام أسواق النفط سيتركز على قرارات الرئيس الأميركي الجديد وعلى قرارات أوبك + وعلى الاقتصاد الصيني خلال 2025."	OBJ
"ويختتم حديثه  : "" أساسيات العرض والطلب بقيت متوازنة في العام 2024 وكبحت جماح ارتفاع الأسعار."	SUBJ
"ويشير استطلاع رأي نشرت "" رويترز "" نتائجه الثلاثاء ، إلى أنه "" من المرجح استمرار أسعار الخام في حدود 70  للبرميل خلال العام الجديد ، وذلك بدعم من توقعات انخفاض الطلب من جانب الصين ( أكبر مستورد للنفط الخام في العالم ) وزيادة المعروض في العالم."	OBJ
"أزمات متلاحقة أستاذة الاقتصاد والطاقة بالقاهرة ، الدكتورة وفاء علي ، تؤكد في تصريحات خاصة لموقع "" اقتصاد سكاي نيوز عربية "" أن : أسواق النفط في العام 2024 قد شهدت سلسلة من الأزمات المتلاحقة ، ما جعلها تبدو في حالة من الهشاشة المفرطة وكأنها تعرضت  "" نوبة قلبية ""!"	OBJ
ومع ذلك ، قد تستعيد الأسواق زخمها خلال العام 2025 ، مما قد يدفع الأسعار لتجاوز المنطقة الرمادية الحالية والعودة إلى مستويات تتجاوز 80  للبرميل ، مما قد يعيد رسم ملامح الاقتصاد العالمي ( شريطة مجموعة من العوامل التي تتفادى تكرار سيناريو 2024 ).	OBJ
ومع اقتراب موعد الانتخابات ، يبقى التساؤل  حول مدى تأثير هذا الدعم على المشهد السياسي الألماني.	SUBJ
انتقد ماسك بشكل خاص السياسة الاقتصادية والبيئية للائتلاف الحاكم ، لا سيما قرار إغلاق المفاعلات النووية ،  ببرنامج الحزب الداعي إلى العودة للطاقة النووية كحل لتحفيز الاقتصاد.	OBJ
كما أيد في الوقت نفسه مواقف الحزب المناهضة للهجرة غير الشرعية ،  على أهمية الحفاظ على الهوية الثقافية والأمن في ألمانيا.	OBJ
بينما على الجانب الآخر ، دافع رئيس تحرير الصحيفة عن قرار نشر مقال الرأي ،  إن الديمقراطية والصحافة تزدهران بفضل حرية الرأي.	SUBJ
"وسلط تقرير  "" رويترز "" الضوء على انتقادات سياسيين ألمان – من الحكومة والمعارضة على حد سواء - بعد موقفه الذي عبر عنه في تغريدته السابقة ثم مقاله في الصحيفة الألمانية ، والذين وصفوا هذا الموقف بأنه شكل من "" التطفل ""."	SUBJ
"ونقل التقرير تصريحات فريدريش ميرز ، وهو زعيم حزب الاتحاد الديمقراطي المسيحي المعارض ، والذي يعد المرشح الأوفر  لخلافة شولتس في منصب المستشار ، والتي قال فيها في مقابلة مع مجموعة فونكه ميديا غروب : "" لا أستطيع أن أتذكر حالة مماثلة من التدخل في تاريخ الديمقراطيات الغربية خلال حملة انتخابية لدولة صديقة "" ،  في الوقت نفسه مقال ماسك بأنه "" تطفلي ومتكلف ""."	OBJ
"التفسير الثاني : استراتيجية واعية لإحداث اضطراب سياسي : هناك قراءة أخرى  أن ماسك يدرك  المشهد السياسي ، وأن دعمه لحزب "" البديل "" قد يكون  بهدف زعزعة الاستقرار السياسي في ألمانيا ، على غرار ما حدث خلال فترة رئاسة دونالد ترامب ، الذي دعم الأحزاب اليمينية الشعبوية في أوروبا لتعزيز ضعف الاتحاد الأوروبي وتقوية النفوذ الأميركي."	OBJ
ويتطرق عمار إلى التأثيرات المحتملة لموقف ماسك ،  أن ذلك الموقف قد يفاقم التوتر بين واشنطن وبرلين ، خاصة في ظل حساسية المرحلة الحالية مع اقتراب الانتخابات في ألمانيا.	OBJ
وقد شهدت ألمانيا  توترات مشابهة خلال فترة ترامب الأولى.	SUBJ
أسباب اقتصادية : ماسك انتقد  السياسات البيئية والاقتصادية لحكومة ألمانيا الحالية ، خاصة تلك التي تقودها الأحزاب التقليدية مثل حزب الخضر.	OBJ
بصفته   في مصنع تسلا في براندنبورغ ، يبدو أن ماسك يشعر بالإحباط من البيروقراطية الزائدة ، ويرى في حزب البديل من أجل ألمانيا إمكانية دعم بيئة استثمارية أكثر مرونة.	OBJ
تجربة ماسك الشخصية مع ابنه المتحول  وقطيعة العلاقة بينهما قد أثرت على آرائه بشأن قضايا مجتمع الميم.	SUBJ
الرغبة في التأثير السياسي : من المحتمل أن يسعى ماسك إلى توسيع نفوذه السياسي عبر دعم أحزاب معارضة في دول كبرى مثل ألمانيا ، مما يمهد لدور أكبر له في السياسة الأميركية .	OBJ
رغم الضجة الإعلامية من المرجح أن يبقى تاثير دعم ماسك  على الناخبين المترددين الذين يركزون على القضايا المحلية والاقتصادية المباشرة بدلا من المواقف الشخصية لشخصيات عالمية مثل ماسك.	OBJ
""" وأكد إسماعيل أهمية تحقيق العدالة  : "" العدالة الحقيقية تعني محاكمة الرموز الكبرى ، أما من نفذ الأوامر تحت التهديد ، فلا يجب أن يكون ضحية الانتقام."	SUBJ
"قال : "" الفن السوري تم تسخيره ليخدم فساد النظام ، لكن الآن يجب أن نعيد للفن دوره التربوي والأخلاقي ، خاصة للأطفال الذين تأثروا  بسبب الحرب."	SUBJ
""" اختتم إسماعيل حديثه برسالة أمل  : "" سوريا بلد متنوع وعظيم ، ولا يمكن حكمه إلا بأخذ رأي الجميع."	SUBJ
التحديات الاقتصادية كذلك تلعب   في تحديد مسار الذكاء الاصطناعي ، حيث أن الاستثمارات الكبيرة في البحوث والتطوير قد تؤدي إلى تزايد الفجوات الاقتصادية بين الدول والشركات القادرة على الاستثمار في هذه التكنولوجيا والمناطق الأقل قدرة على مواكبتها.	OBJ
سنحتاج بالتأكيد إلى إنجازات أكثر  في المرحلة المقبلة.	SUBJ
وقد تدفع هذه التحسينات الذكاء الاصطناعي نحو تحقيق أرباح للمستخدمين التجاريين ، وهو ما لم يحدث بعد ، على الرغم من الاستثمارات التي من المتوقع أن تتجاوز تريليون دولار في السنوات المقبلة ،  لتقرير حديث من غولدمان ساكس.	OBJ
"فقد كتب سام ألتمان ، الرئيس التنفيذي  OpenAI ، على منصة "" إكس "" في نوفمبر الماضي : "" لا يوجد جدار ( حاجز ) "" ، في رد على تقارير تشير إلى أن الإصدار الأخير من ChatGPT - 4 كان أفضل بشكل معتدل فقط مقارنة بالنماذج السابقة."	OBJ
هذه المرحلة الجديدة قد تكون المفتاح لجعل الذكاء الاصطناعي أكثر فاعلية  مع احتياجات المجتمع ، مع مراعاة الأخلاقيات والمسؤولية.	SUBJ
"الصين تحظر تصدير معادن رئيسية إلى أميركا أخبار الشركات "" غيلسنغر "" يضطر للرحيل عن إنتل بعد فشل خطته الطموحة وأوضح أن المرحلة الأولى من تطور الذكاء الاصطناعي كانت بمثابة "" ملعب مفتوح "" ، حيث استطاع أي لاعب جديد أن يحقق مكاسب كبيرة بسهولة  لندرة المنافسة."	SUBJ
"ومع تطور السوق وزيادة عدد الشركات العاملة فيه مثل "" أوبن أيه آي "" ، و "" أنثروبيك "" ، وشركات أوروبية مثل "" ديب سيك "" أصبحت المنافسة أكثر صعوبة ."	OBJ
كما أشار  إلى أن التحديات السياسية والدولية قد تضيف أعباء إضافية ، خاصة فيما يتعلق بنقل الأفكار وبراءات الاختراع بين الدول ، مما يعزز من تعقيد المشهد التنافسي في هذا المجال.	OBJ
"بحسب تقرير لشبكة "" سي إن بي سي "" الأميركية ، اطلع عليه موقع "" اقتصاد سكاي نيوز عربية "" ، فقد بلغت خسائر المستهلكين - في الولايات المتحدة - نتيجة عمليات الاحتيال 10 مليارات دولار في العام 2023 ، وهو رقم قياسي جديد  للجنة التجارة الفيدرالية."	OBJ
وأضاف : هناك عدد من النصائح التي يمكن توجيهها لكبار السن  ، على النحو التالي : يجب توخي الحذر الشديد في التعامل مع المكالمات أو الرسائل التي تطلب تفاصيل مثل أرقام الهوية أو الحسابات المصرفية ، خاصة من جهات غير معروفة.	OBJ
يجب التحقق  من مصدر هذه العروض عبر جهات رسمية أو أشخاص موثوقين.	SUBJ
إذا تعرض الشخص لأي محاولة احتيال ، فعليه التواصل مع الجهات المختصة .	SUBJ
"واختتم حديثه  : "" الأمان المالي لكبار السن ليس مسؤوليتهم فقط ، بل مسؤولية المجتمع ككل ، من خلال تعزيز التوعية والإبلاغ عن أي سلوك مريب ""."	OBJ
من جهتها هاجمت كامالا هاريس خلال حملتها الانتخابية قانون خفض الضرائب الذي أقر خلال عهد ترامب ، ووصفته بأنه هدية للمليارديرات والشركات ، مشيرة إلى أنه فشل في الوفاء بالمتطلبات ، ووعدت بتصحيح مسار الأمور من خلال رفع الضريبة .	OBJ
"في هذا السياق ، يشير تقرير لصحيفة "" واشنطن بوست "" إلى أنه على الرغم من إلحاح أصوات الجمهوريين المؤيدين  "" جعل أميركا عظيمة مرة أخرى "" على التقليل من قوة الاقتصاد الأميركي ، فإن التعافي الاقتصادي الذي شهدته الولايات المتحدة على مدى الأعوام القليلة الماضية لم يكن أقل من معجزة."	OBJ
كما رفع صندوق النقد الدولي توقعاته للنمو الاقتصادي الأميركي على مدى العامين المقبلين ،  أن أكبر اقتصاد في العالم تمتع بأقوى تعافي من الجائحة مقارنة بأي دولة متقدمة.	OBJ
"وقالت : "" منذ اليوم الأول ، رفضنا الانعزالية التي جعلت أميركا والعالم أسوأ  ، وسعينا إلى قيادة الاقتصاد العالمي الذي يدعم الاقتصادات في مختلف أنحاء العالم ويجلب فوائد كبيرة للشعب الأميركي والاقتصاد الأميركي ""."	SUBJ
 لتقدير واحد ، فإن خطة ترامب فيما يخص التعريفات من شأنها أن تخفض الناتج المحلي الإجمالي بنحو 9 بالمئة.	OBJ
ستستفيد القطاعات الاستهلاكية وقطاع الخدمات بشكل خاص من تخفيض الضرائب ، في حين قد يتأثر قطاع الطاقة  بسبب التوجهات نحو التنقيب المكثف عن النفط الذي قد يؤدي إلى انخفاض الأسعار نتيجة زيادة العرض.	OBJ
"تؤكد تقديرات من مؤسسة "" كابيتال إيكونوميكس "" أن ارتفاع العجز في ظل إدارة ترامب سيضغط على معدلات الفائدة  ، مما سيضعف أداء السندات."	OBJ
أما حول الدولار الأميركي : ترامب : سياسات ترامب الحمائية قد تعزز من قيمة الدولار  نتيجة التوقعات بزيادة التعريفات وارتفاع الفائدة.	OBJ
فيما يخص هاريس ، فستدعم استمرارية السياسات الحالية فيما يخص الدولار  لاستمرار سياسات التحفيز المالي وضغط التضخم المنخفض ، مما يسمح بالخفض التدريجي للفائدة وتعزيز الاقتصاد.	OBJ
"من جانبه ، يقول الخبير الاقتصادي ، علي الإدريسي ، في تصريحات خاصة لموقع "" اقتصاد سكاي نيوز عربية "" إن تفضيل الأسواق لهاريس أو ترامب يعتمد على عدة عوامل تتعلق بالسياسات الاقتصادية لكل منهما والتوجهات المتوقعة في حال فوز أي منهما ،  : "" بشكل عام ، الأسواق المالية تميل إلى تفضيل السياسات التي تعزز النمو الاقتصادي وتقلل من المخاطر وعدم اليقين ""."	OBJ
هذا النهج الحمائي يعتبر مصدر قلق ، حيث يمكن أن يؤثر  على النمو الاقتصادي العالمي ويزيد من المخاطر.	SUBJ
ومن المتوقع أن يؤثر ذلك  على أسهم الشركات ، وقد يؤدي إلى انخفاض كبير في معظم مؤشرات السوق.	SUBJ
"وقد تم الكشف عن حجم التهديد من خلال استطلاع رأي أجري  لأكثر من 500 مؤسس شركة ، حيث قال 72 بالمئة منهم إنهم "" درسوا بالفعل إمكانية نقل أنفسهم أو أعمالهم إلى الخارج "" ، وفق تليغراف."	OBJ
"خطط زيادة الضرائب من جانبه ، قال مدير المركز العالمي للدراسات التنموية والاقتصادية ، صادق الركابي ، في تصريحات خاصة لموقع "" اقتصاد سكاي نيوز عربية "" إن المملكة المتحدة تواجه تحديات اقتصادية كبيرة ، حيث أعلنت الحكومة  عن خطط لزيادة الضرائب وخفض الإنفاق."	OBJ
وأضاف الركابي : تزداد مخاوف المستثمرين والشركات بزيادة الضرائب ما يؤثر  على الربحية.	SUBJ
وعدد الركابي النتائج السلبية لمغادرة الشركات الأجنبية بريطانيا وتشمل ( فقدان العديد من الوظائف ، وارتفاع معدلات البطالة ، والتاثير  على الإنفاق الاستهلاكي ).	OBJ
وشدد على أن ترامب يتصف بمزيج فريد من الذكاء التجاري والعفوية والعشوائية ، وفي بعض الأحيان العدائية والمواجهة ، وهو يدرك  كيف ومتى يغير سياسته ومواقفه حال شعوره بأنها مقبلة على الفشل.	SUBJ
وكل ذلك حدث في فترة بايدن ، لذا يقدم ترامب نفسه كرجل سلام قادر على تحقيق السلام عالميا وبالتالي تجنيب الولايات المتحده الانخراط في حروب وصراعات خارجيه والتركيز على الاستثمار في الداخل بدلا من إرسال الدعم والتمويل الى الخارج وهذا النوع من الخطاب يهدف إلى دغدغه مشاعر الأميركيين نحو القومية والوطنية المتزايدة ويصور ترامب نفسه على أنه رائد هذا الشعور والشخص المخلص الذي سيعيد أميركا اقوى .	OBJ
هذا النهج يعتبر  ذو حدين ؛ فهو قد يؤدي إلى ارتفاع الأسعار على المستهلك ، لكنه في المقابل سيدعم الاقتصاد الأميركي.	OBJ
ذلك في وقت يظل فيه الاقتصاد  على رأس قائمة أولويات الناخبين.	SUBJ
طرح الاستطلاع الأخير أسئلة أكثر  من الاستطلاع السابق ، وخلص إلى أن 46 بالمئة يفضلون سياسات هاريس بشأن الضرائب على الطبقة المتوسطة ، مقارنة  35 بالمئة يفضلون ترامب.	OBJ
وتأتي هذه الدفعة التي حصلت عليها هاريس حتى في الوقت الذي يعتقد فيه أغلبية الناخبين ، 62 بالمئة ، أن الاقتصاد في حالة سيئة ، مقارنة  38 بالمئة يقولون العكس.	OBJ
 لهجمات إسرائيلية وشيكة ، تشهد إيران اضطرابات اقتصادية واسعة ، تضاف إلى جملة أزمات البلد الذي الذي يرزح تحت وطأة أوضاع اقتصادية صعبة في ضوء انخراطه في جملة من الصراعات ، علاوة على تأثره بتبعات العقوبات المفروضة عليه على نطاق واسع.	OBJ
جزء من هذا التأثير وهذه التداعيات الاقتصادية مرتبط  بطبيعة بنك الأهداف الإسرائيلي وطبيعة الضربة الإسرائيلية والأهداف المرصودة.	SUBJ
"ويشير إلى أنه في حالة استهداف المؤسسات النووية أو المنشآت المرتبطة بها "" قد تكون هناك تداعيات اقتصادية أخطر  على إيران ومعظمها ربما يجر إلى الحرب الواسعة والشاملة ، والتي تشهد تخصيص عديد من الموارد لمواجهة إسرائيل في تلك الحرب ، مما سيؤدي إلى إعادة توجيه كافة الموارد لحشد القدرات العسكرية والاستقطابات الاقتصادية ، وبما لذلك من تداعيات اقتصادية."	OBJ
وهذه التحديات في صميم أولويات إيران خلال قمة البريكس الأولى المنعقدة  في روسيا.	OBJ
 لتقارير وسائل الإعلام المحلية ، ارتفعت أسعار الخبز بنسبة 200 بالمئة خلال العام الماضي ، في حين شهدت الضروريات الأساسية الأخرى ، مثل المياه والإسكان ، ارتفاعات حادة في الأسعار.	OBJ
اتخذت الحكومة الإيرانية  إجراءات تمثلت في رفع الدعم عن بعض القطاعات ،.	SUBJ
يمكنك  التفكير في تعزيز معرفتك المالية لتحقيق المزيد من النجاح.	SUBJ
"ومن جهتها ، قالت الصحفية الاقتصادية باتريسيا جلاد في حديث لموقع "" اقتصاد سكاي نيوز عربية "" ، إن أي فنان على قيد الحياة  ، بات عليه التفكير  في القرار الذي سيتخذه بشأن تركته ، وما إذا كان سيسمح لورثته باستخدام الذكاء الاصطناعي ، لإعادته إلى العمل مرة جديدة."	OBJ
"وعلق ماكيبين  : "" إنه مثل الحفلة في المقدمة والصداع بعد أربع سنوات ""!"	SUBJ
في الوقت نفسه ، يجادل الباحثون بأن المستثمرين سيشعرون بالذعر من الاحتياطي الفيدرالي المسيس وسيبدأون في توجيه رؤوس أموالهم إلى دول أخرى  من العام 2026.	SUBJ
وبالتالي فإن السيطرة على بنك الاحتياطي الفيدرالي سوف تحقق لترامب نتائج عكسية ، على الرغم من أنه يعد بأجندة اقتصادية أميركية .	SUBJ
049 تريليون دولار لخدمة الدين  بزيادة قدرها 30 بالمئة مقارنة بالعام الماضي ، وهذا جزء من إجمالي متوقع يبلغ 1.	OBJ
"الذكاء الاصطناعي التوليدي يتمتع بالقدرة على أن يكون "" تكنولوجيا ثورية "" ، حيث إن الكفاءات التي يمكن أن يجلبها إلى عديد من الخدمات مثل الصناعات التجارية والقانونية والطبية المالية والنقل ستصبح واضحة وسهلة في وقت أقرب مما يتوقعه الكثيرون ، كما يرى تقرير  "" سيتي بنك ""."	OBJ
 إلى ترامب على أنه يمثل مصالح الشركات الكبرى بشكل أفضل ( 64 بالمئة مقابل 20 ) والأثرياء ( 67 بالمئة مقابل 19 ) بهامش أوسع.	OBJ
 من ذلك ، وافقت المجموعة على إدراج بلدين مصدرين للطاقة في الشرق الأوسط ( المملكة العربية السعودية والإمارات العربية المتحدة ) ، وإيران المعزولة ، ومصر صاحبة أكبر تعداد سكاني في المنطقة العربية ، وإثيوبيا الفقيرة للغاية ، والأرجنتين ، وهي دولة تعاني من اضطرابات مالية شبه دائمة.	OBJ
"وتابع الملخص  : إن وانغ حث دول البريكس على الوقوف ضد "" تسييس وتأمين القضايا الاقتصادية وزيادة العقوبات الأحادية الجانب والحواجز التكنولوجية "" - وكلها رموز للسياسات الأمريكية التي تعارضها بكين."	OBJ
على سبيل المثال ، أصبحت بكين تتوقع من زعماء العالم النامي الموافقة  على مبادرة الأمن العالمي ، التي تتعارض مبادئها مع المثل العليا والممارسات في الشؤون الدولية التي تفضلها الولايات المتحدة وحلفاؤها.	OBJ
فقد ربط مبعوث صيني لدى الأمم المتحدة الوضع في البحر الأحمر بالصراع بين إسرائيل وحماس في غزة ،  إلى أن الاضطرابات في المنطقة هي نتيجة للسياسة الخارجية الأميركية.	OBJ
"ووصف أحد الدبلوماسيين هذا الجهد بأنه "" مقاطعة خفية "" لمؤتمر السلام ، واتهم الرئيس الأوكراني فولوديمير زيلينسكي الصين  بمساعدة روسيا في تخريب القمة."	SUBJ
ومع ذلك ، فإن معظمها يستفيد  من علاقاتها بالولايات المتحدة بحيث لا تخاطر بقطعها.	SUBJ
لكن واقع المستطيل الأخضر كان مختلفا تماما ، بل أن حنبعل المجبري ، أضحى خارج اهتمامات ناديه في بداية موسم 2024  2025 ، بعد أن قضى نصف الموسم الماضي في بين مانشستر يونايتد وإشبيلية الإسباني الذي انتقل إليه على سبيل الإعارة في يناير 2024.	OBJ
وانتقل حنبعل المجبري إلى مانشستر يونايتد صائفة 2019  من موناكو الفرنسي وانضم بعمر 16 عاما لفريق الناشئين.	OBJ
"يؤكد القلصي  "" سكاي نيوز عربية "" قائلا : "" للموسم الثالث على التوالي منذ انتقاله للمان يونايتد في صيف 2021 يجد المجبري نفسه في مصير غامض ويواجه خطر الموسم الأبيض ، مستوى اللاعب بعيد عن قدرته على النجاح في البريمرليغ فما بالك إذا تعلق الأمر بمانشستر يونايتد ، على المجبري ووكلائه أن يعرفوا الوجهة المناسبة والتي تضمن للاعب خط وسط تونس القدرة على النجاح قبل فوات الأوان ""."	OBJ
ومن ضمن بنود رؤيتها الاقتصادية ، ومثلما هو الحال مع المرشحين الديمقراطيين في كل انتخابات رئاسية ، ترغب هاريس في فرض ضرائب أعلى على الأثرياء  ، واستخدام العائدات لتخفيف العبء عن الأسر من الطبقة الوسطى ، خاصة تلك التي لديها أطفال.	OBJ
الأزمة مع الصين : ستكون هناك قرارات صعبة بشأن الصين وما سيذهب له هذا الملف ، كأن يتم توجيه رسالة واضحة بأن الصين لا يمكنها الاستمرار بهذه السياسات التوسعية وقرصنة المنتجات والتجسس على الشركات الأميركية ، وفي نفس الوقت لا يؤدي ذلك إلى حرب اقتصادية كبرى لن تؤثر حينها فقط على أميركا والصين لكن  على العالم أجمع ، فيجب التعامل مع تلك المشكلة بشكل قوي وواضح وحازم لا يؤدي إلى مشكلة اقتصادية تضاف إلى المشاكل الموجودة  اليوم.	OBJ
"ويتحدث في الوقت نفسه عن ملف "" توفير فرص العمل "" ،  على أنه بالنسبة للمواطن الأميركي المشاكل وتفسيراتها مختلفة ، بينما هو يحتاج إلى فرص عمل وينظر كيف ستقدم له الحكومة الأميركية القادمة فرص عمل."	OBJ
وأشار إلى أن ترامب بحسب برنامجه الانتخابي سيتخلى عن الإنفاق الحكومي المفرط ووقف التوغل الأميركي في صراعات خارجية  ، إضافة إلى خفض أسعار الفائدة وخفض ضرائب الأفراد واستخدام الإيرادات من الرسوم الجمركية لتمويل المشروعات.	OBJ
تلقي المرشحة الديمقراطية لانتخابات الرئاسية ونائبة الرئيس الأميركي ، كامالا هاريس  ، اليوم ( الجمعة ) ؛ للإعلان عن خطتها الاقتصادية ، وهي المرة الأولى التي تطلق فيها هاريس مبادرة سياسية كبرى منذ انسحاب الرئيس بايدن من السباق الشهر الماضي.	OBJ
 للباحثين ، من الضروري لمطوري الذكاء الاصطناعي ، تأمين وصول برامجهم إلى البيانات عالية الجودة من صنع الإنسان ، والتي لم يتم تلويثها بمحتوى الذكاء الاصطناعي ، فرغم أن القيام بهذا الأمر يعد مهمة مكلفة ، إلا أنه وحتى الآن لا توجد طريقة أخرى للحفاظ على دقة برامج الذكاء الاصطناعي.	OBJ
لكن الوضع بدا مختلفا في مدينة حيفا ، التي من المرجح أن تتعرض للصواريخ  إذا تصاعدت الأعمال العدائية بين إسرائيل وحزب الله.	OBJ
" النظام من "" استلام رسالة في حالات الطوارئ واسعة النطاق ، مثل إطلاق الصواريخ على إسرائيل "" ، وفق الجيش الإسرائيلي."	OBJ
 ، سوف يحل الرئيس الأمريكى دونالد ترامب بالبيت الأبيض ، ويصبح بقدرته اتخاذ القرارات.	SUBJ
سيكون تركيزي هنا أضيق  ؛ حيث سأقيم أداء إدارة بايدن من خلال عدسة الالتزامات التي قطعتها تجاه الأميركيين العرب في عام 2020.	SUBJ
وكان أفضل ما قدمته الولايات المتحدة  على ذلك هو التعبير عن القلق.	SUBJ
مشروع نتنياهو وخطابه المعلن يرفض حل الدولتين ، ويعتبر أن اتفاق أوسلو ، الذى مثل اتفاق السلام الوحيد بين الجانبين الفلسطينى والإسرائيلى ، هو سبب عملية 7 أكتوبر ، كما أعلن رفضه عودة السلطة الفلسطينية لحكم قطاع غزة ، واعتبر أن فتح وحماس وجهان لعملة واحدة وأنه يرفض حكم « فتحستان » و « حمستان » ، معتبرهما وجهين للتطرف والإرهاب ، فى حين أن العالم والأمم المتحدة والشعب الفلسطينى يرغبون أن يكون هذا الاتفاق  ليس فقط لوقف مجازر غزة ، إنما بداية لاستعادة حقوق الشعب الفلسطينى المشروعة وبناء دولته المستقلة.	OBJ
وبعد سقوط « الخلافة العثمانية » السيئة الذكر ، برز اتجاهان مهمان ؛ الأول : « الدول » التي سعت لوراثة هذه الخلافة  ، فقام الشريف حسين والملك فؤاد وإمام اليمن مطالبين بهذه الوراثة ومتنازعين عليها ، وكان عبد العزيز هو الذي صنع الفارق ، وفي كتاب « ملوك العرب » لأمين الريحاني وكتابات شكيب أرسلان وغيرهما ، تفاصيل لافتة عن تلك المرحلة المهمة.	OBJ
والاتجاه الثاني كان عبر فكرة أن « الجماعة » المنظمة يمكن أن ترث « الخلافة » ، وهي الفكرة التي قادها الأفغاني وعبده ، وخرجت منها  « جماعة الإخوان المسلمين » ، وقد خرجت الفكرة في فرنسا مع الأفغاني وعبده ، وفي الهند مع « المودودي » ، وورثتها الحركات المنبثقة عن هذا الفكر ، في استقلال باكستان ، وفي « جماعة الإخوان المسلمين » بمصر التي حظيت منذ نشأتها الأولى بدعم بريطاني سخي ، لإضعاف الدولة الوطنية.	OBJ
لكن ربما هي المرة الأولى في تاريخ الحروب العسكرية ، أن  يعمد إلى إطلاق النار لمناسبة وقف النار.	SUBJ
مع تولي الرئيس الأميركي المنتخب دونالد ترامب السلطة في البيت الأبيض في 20 يناير الجاري ، ثمة سؤال يتردد مؤداه : كيف سيتعامل الرئيس الأميركي الجديد  مع القضايا العربية والشرق الأوسط ، والتي اعتمد فيها على لغة التهديد والوعيد ، مقارنة بتصريحات مشابهة للحرب في أوكرانيا أو السلوك الروسي أو التعامل مع حلف « الناتو » والشركاء الأوروبيين ، في إطار تعريفه للأمن الأوروبي ، والعمل مع الحلفاء في مناطق العالم.	OBJ
ومن ثم ، فإن الحديث عن دور أميركي أمر طبيعي بالفعل ، ولكن سيبقى للولايات المتحدة العمل وفق مصالحها الكبرى ، والمتعلقة بالوجود العسكري الكبير وحجم الشراكة ، والتي لا يمكن للولايات المتحدة إلا أن تتعامل معه في ظل ما تملكه الدول العربية  من خيارات لمناكفة السياسة الأميركية في حال تعارض مصالح بعض الدول العربية وهو ما تفهمه الإدارة الأميركية الجديدة ، خاصة أن التحولات الجارية في النظام الدولي ستسمح لدول أخرى ، ومنها روسيا والصين بالفعل للعب دور رئيس فيما سيجري ، وفي ظل الأهمية الاستراتيجية الكبيرة للعلاقات العربية مع الشريك الأميركي.	OBJ
بعض فقراته كما يلي : في المقدمة كان القول : « من الطبيعي أن لكل حرب نهاية ، ويبدو أن حرب غزة قد وضعت لها ( الخريطة الزرقاء ) سيناريو مشهد نهايتها ، تلك الخريطة تم الحديث عنها منذ أسابيع في الغرف الخلفية ، وتم الإشارة إلى بعض خطوطها  ، وهي خطة تشترك فيها جميع الأطراف ، سواء كانت فلسطينية ( من خلال وسطاء عرب ) أو إسرائيلية أو أميركية وغربية ، وقد ذهبت بريطانيا العارفة بمنطقة الشرق الأوسط للتلويح بالجزرة ، حيث قال وزير خارجيتها المخضرم : ( نحن نفكر بالاعتراف بدولة فلسطين ) »!	OBJ
أما المرحلة التالية ، فستكون  هائلة لنقل وإزالة خطر بقايا المباني المدمرة ، والتي باتت سامة الآن ، بسبب تسرب مياه الصرف الصحي والكميات الهائلة من المواد الكيماوية التي استخدمت في إخماد النيران.	OBJ
فمشاركة الأفراد يعزز الشعور بالسعادة ويؤدي إلى زيادة روح التعاون ، وينعكس على المجتمع ليكون أكثر إيجابية وحيوية   ويجعل البيئة ممتعة للعيش والحي القرارات الانفعالية أو الإقصائية والتهميش وما في حكمه مردودها ذو أثر سلبي كبير وخطير سواء على المدى القصير أو البعيد للمجتمع.	OBJ
فشعب المملكة شعب عظيم يستحق الأفضل ، وقيادتنا تسعى  لتحقيق كل رفاهية وازدهار لجميع أرجاء وربوع المملكة.	SUBJ
لا شك من التشابه الكبير في الرؤية بين شهاب وعون ، إلا أن الأول خطط أما الثاني فبدروس الماضي والأدوات الحديثة سيتم تنفيذ رؤيته لدعم الإصلاحات والتغلب على التحديات الجديدة ،  إذا التزم لبنان بسياسة خارجية متوازنة تحافظ على حياد لبنان الإيجابي في النزاعات الاقليمية والدولية.	OBJ
لطالما حرصت وسائل الإعلام الرسمية بإيران  على تصوير الجمهورية الإسلامية في موقع قيادي عالمي.	SUBJ
والحقيقة أن روسيا ، التي تلامس القطب الشمالي ، تقع إلى الشمال من كل دولة أخرى بالعالم .	OBJ
وتتمثل أكبر الصادرات الإيرانية إلى روسيا في الفلفل الأخضر ، بينما  الذهب أكبر صادرات موسكو إلى طهران.	SUBJ
في أفريقيا جنوب الصحراء الكبرى ، عقدت 10 دول ، على الأقل ، من بينها السنغال وغانا  ، انتخابات ديمقراطية ، بينما يشير « مؤشر الحرية » إلى إنجاز تقدم داخل قرابة 20 دولة أخرى.	OBJ
فالاثنان  ، السلطة والموالاة ، هما قوتان تمنحان لفرد أو جماعة لإدارة شؤون الدولة والمجتمع.	SUBJ
وهذا ما يمكن وصفه بالمسؤولية الأخلاقية في حماية مسار صعب وطويل من أجل حماية السلطة من خصومها ومن نفسها .	SUBJ
طريقة إدارة الحرب خلال الشهور الماضية ، وكذلك المفاوضات تحتاج  إلى مراجعات.	SUBJ
التاريخ وما سيحدث  كفيلان بالحكم.	SUBJ
تاريخيا ، وبعيدا عن الخليج ، يعتبر اليمن مصدر الفن في الجزيرة العربية ، لتوافر متطلباته فيه ، من تراث وأدوات ومواد ، وقربه من المنابع الأفريقية والهندية ، وكلها أمور لم تكن  تتوافر في غالبية أصقاع الجزيرة ، خاصة صحارى الوسط.	OBJ
ويعد الغناء الصنعاني من أقدم أنواع الموسيقى فيها ، وامتاز  بألحانه العميقة وكلماته الشعرية ، وتم إدراجه ضمن قائمة التراث الثقافي لليونيسكو.	OBJ
كما أن هناك فن النهمة ، الذي يؤديه « النهام » على ظهر السفينة لتحفيز البحارة وتسليتهم أثناء العمل ، الشاق .	SUBJ
هكذا كانت الكويت ، رائدة في كل شيء ، وستعود لما كانت عليه ، فهذه من طبائع الأمور ، فقد كانت  دولة منفتحة على الآخر ، وعلى كل جديد ، وضد الانغلاق والتشدد.	SUBJ
هذا القرار لا يؤثر فقط على حياة كبار السن اليوم ، بل يسهم  في تشكيل ثقافة اجتماعية تقوم على احترام الكبار والعناية بهم.	SUBJ
في الختام ، القرار الموفق من النيابة العامة ليس مجرد مبادرة إدارية أو خطوة تنظيمية ، بل هو انعكاس  لرؤية القيادة التي جعلت من الإنسان محور اهتمامها ، ووضعت كرامته في صميم أولوياتها.	SUBJ
وأفادت مراسلتنا نقلا عن مصدر وزاري لبناني بأن الحكومة اللبنانية قررت تسليم عبد الرحمن القرضاوي إلى دولة الإمارات.	SUBJ
القرضاوي يواجه عدة تهم تتعلق بنشر مضامين تحريضية وخطابات تهدف لإثارة الفوضى في دول مثل مصر ، الإمارات ، والسعودية.	OBJ
"وأوضح أحمد بان أن "" محاكم مصرية أصدرت ثلاثة أحكام قضائية ضد عبد الرحمن القرضاوي بتهمة نشر أخبار كاذبة ، إهانة القضاء ، والتحريض على العنف ""."	OBJ
من جانبه ، يرى المصدر الوزاري اللبناني أن القرار جاء في إطار التزامات لبنان الدولية واحتراما للعلاقات مع الدول العربية ، لا سيما الإمارات.	SUBJ
"وأكد الباحث بان أن "" لبنان يحاول التخفيف من وطأة النفوذ الإقليمي غير العربي وتعزيز علاقاته مع محيطه العربي ""."	SUBJ
القرضاوي ، الذي يحمل الجنسية التركية ويعيش في تركيا ، لطالما اتخذ موقفا عدائيا تجاه النظام السوري السابق ، ودول عربية أخرى.	OBJ
ولم تتوقف تصريحاته عند هذا الحد ؛ إذ أعلن أيضا عدم استبعاده أي خيارات ، بما فيها التحركات العسكرية ، لضم كل من قناة بنما وجزيرة غرينلاند.	OBJ
"وأشار ترامب إلى أن "" إزالة الخط الافتراضي بين كندا والولايات المتحدة سيخلق شيئا عظيما "" ، معبرا عن محبته للكنديين ، لكنه انتقد ما أسماه التكاليف الباهظة لحمايتهم."	SUBJ
واعتبر أن كندا تمتلك موارد ومساحات شاسعة يمكن أن تعزز قوة الولايات المتحدة.	SUBJ
أما بشأن غرينلاند ، فقد أوضح ترامب أن الجزيرة تمتلك أهمية استراتيجية بسبب موقعها الجغرافي والمعادن الثمينة التي تحتويها.	SUBJ
وأشار إلى قلقه من النفوذ الصيني والروسي المتزايد في المنطقة.	SUBJ
"كما اعتبر قناة بنما "" ضرورة للأمن الاقتصادي الأميركي "" ، مؤكدا أنها بنيت في الأصل لخدمة الجيش الأميركي."	SUBJ
"ردود الفعل الدولية وجاء رد كندا سريعا وحاسما ؛ إذ صرحت وزيرة الخارجية الكندية ، ميلاني جولي ، بأن بلادها "" لن تتراجع أمام تهديدات ترامب "" ، مشيرة إلى أن كندا لن تكون أبدا جزءا من الولايات المتحدة."	OBJ
"وأضافت أن تصريحات ترامب تعكس "" عدم فهمه لما يجعل كندا قوية ""."	SUBJ
وفي غرينلاند ، رفضت السلطات المحلية أي حديث عن الانضمام إلى الولايات المتحدة ، مؤكدة أن مستقبل الجزيرة يحدده سكانها فقط.	SUBJ
"رأي الخبراء فريد فليتز ، نائب رئيس معهد "" أميركا أولا "" ، أوضح أن تصريحات ترامب تأتي في سياق رؤيته لتوسيع النفوذ الأميركي."	OBJ
"وقال في مقابلة مع سكاي نيوز عربية : "" ترامب رئيس غير تقليدي يتجاوز الحدود المعتادة "" ، مشيرا إلى قلق ترامب من النفوذ الصيني في بنما وغرينلاند."	OBJ
"وأضاف فليتز أن دعوة ترامب لضم كندا أو غرينلاند ربما تكون "" تكتيكات تفاوضية "" للحصول على امتيازات اقتصادية وتجارية."	OBJ
لكنه أكد أن استخدام القوة العسكرية ، رغم أن ترامب لم يستبعده ، يبقى أمرا غير واقعي في الظروف الحالية.	SUBJ
تصريحات ترامب أثارت تساؤلات حول مدى جديته في هذه المطالبات.	SUBJ
هل هي طموحات توسعية غير مسبوقة ، أم أنها مجرد أدوات تفاوضية تثير الجدل الإعلامي وتضغط على الخصوم لتحقيق مكاسب ؟	SUBJ
ما الذي ينتظر الاقتصاد البريطاني هذا العام ؟	SUBJ
يعاني الاقتصاد من ارتفاع معدلات التضخم أعلى من مستهدفات بنك إنجلترا ، وضعف الثقة في ظل زيادة الضرائب على أرباب العمل.	OBJ
مما يضع حكومة كير ستارمر أمام اختبار حقيقي لتحقيق وعودها بتحفيز النمو وتحسين الأوضاع الاقتصادية.	SUBJ
أخبار ذات صلة بحسب التقرير ، فإنه بعيدا عن الإشارة إلى التعافي ، أظهرت أحدث البيانات استقرار الناتج المحلي الإجمالي في المملكة المتحدة ، مع ضعف الثقة ، حيث تستعد الشركات لزيادة قدرها 25 مليار جنيه إسترليني في مساهمات التأمين الوطني لأصحاب العمل في أبريل.	OBJ
وباعتبار أن حزب العمال استبعد كل وسيلة أخرى لجمع الإيرادات ، فقد كان هذا أحد المجالات القليلة التي كان بوسع وزيرة الخزانة راشيل ريفز اللجوء إليها لتمويل الخدمات العامة.	SUBJ
ويشير التقرير إلى أن : ارتفاع أقساط التأمين الوطني ليس العامل الوحيد المؤثر.	SUBJ
فقد كان من المتوقع بالفعل أن يتباطأ النمو الاقتصادي ، مع استقرار أسعار الفائدة عند 4.	SUBJ
75 بالمئة وقلق البنك المركزي بشأن التضخم.	SUBJ
إن ما ستؤول إليه الأمور في الأشهر القليلة المقبلة سيكون حاسما في ترسيخ سمعة حزب العمال الاقتصادية.	SUBJ
3 بالمئة في العام 2025.	SUBJ
ويتوقع مكتب مسؤولية الميزانية 2 بالمئة ، حيث يعمل الإنفاق العام الأعلى لريفز على تعزيز الطلب.	SUBJ
من شأن النمو القوي للأجور الحقيقية أن يمنح المستهلكين بعض القوة الشرائية التي يحتاجون إليها بشدة.	SUBJ
"من بين الأسئلة الأخرى التي طرحها التقرير ، ما يتعلق بثورة الذكاء الاصطناعي وما إن كانت "" فقاعة "" ؟"	SUBJ
وهل يستيقظ صناع السياسات الاقتصادية على حالة طوارئ مناخية ؟	SUBJ
اقتصادات الدول الأوروبية على حافة الهاوية فيما يأتي السؤال الملح : هل تؤدي رسوم ترامب الجمركية إلى إشعال حرب تجارية ؟	OBJ
ومن المتوقع أن ينتعش الاقتصاد البريطاني بنسبة 1.	SUBJ
7 بالمئة في العام 2025 لكن القضايا الجيوسياسية تلوح في الأفق ، بحسب أحدث تقرير للتوقعات الاقتصادية لشركة KPMG.	OBJ
"ووفق التقرير الذي اطلع موقع "" اقتصاد سكاي نيوز عربية "" عليه ، فإنه بينما تتطلع المملكة المتحدة إلى المزيد من النمو في العام 2025 ، فإن العام قد يجلب معه تحديات متجددة ناجمة عن ارتفاع وتيرة التضخم ، وزيادة الاحتكاكات التجارية ( بالنظر إلى السياسات التجارية المرتقبة للرئيس الأميركي دونالد ترامب ) ، وتفاقم حالة عدم اليقين الاقتصادي."	OBJ
وسوف يعتمد التأثير النهائي على استجابات السياسات والتفاعل بين هذه الاتجاهات على نطاق عالمي.	SUBJ
"تأثير السياسات الأميركية في هذا السياق ، يشير خبير الشؤون السياسية والاقتصادية ، الدكتور حميد الكفائي ، في تصريحات خاصة لموقع "" اقتصاد سكاي نيوز عربية "" إلى أن الاقتصاد البريطاني يتوقع أن ينمو بنسبة 1."	OBJ
ارتفاع الأجور : وافقت حكومة حزب العمال على مطالب النقابات برفع الأجور ، بعد أن كانت مجمدة لفترة طويلة من قبل حزب المحافظين.	OBJ
خفض أسعار الفائدة : يتوقع أن يقوم بنك إنكلترا المركزي بخفض أسعار الفائدة ثلاث مرات هذا العام ، مما سيقلل من حوافز التوفير ويدفع المستهلكين إلى زيادة الإنفاق.	OBJ
ويحذر الدكتور الكفائي من تأثير السياسات الأميركية ؛ إذ يمكن أن يؤدي رفع التعرفات الجمركية من قبل الرئيس الأميركي دونالد ترامب إلى تقليص نمو الاقتصاد البريطاني إلى 1.	OBJ
كما يشير في الوقت نفسه إلى توقعات بارتفاع معدل التضخم إلى 2.	SUBJ
4 بالمئة هذا العام ، بدفع من زيادة الضرائب على أرباب العمل وارتفاع الأجور (.	OBJ
أخبار ذات صلة ويخلص الكفائي إلى أن الاقتصاد البريطاني سيستفيد من سياسات حكومة العمال التي تركز على تحفيز الإنفاق ، رغم التأثيرات السلبية المحتملة على التضخم.	OBJ
ويختم حديثه بالتأكيد على أن الاقتصاد البريطاني سيكون في وضع أفضل في 2025 مقارنة بالعام الماضي ، بفضل السياسات الاقتصادية المحفزة لحكومة العمال ، على حد وصفه.	OBJ
"وأظهر استطلاع رأي لما يقرب من مئة خبير اقتصادي ، نشرته صحيفة "" فايننشال تايمز "" البريطانية ، مجموعة من التوقعات بشأن أداء الاقتصاد البريطاني في العام الجديد ، ومن بين أبرز الأفكار التي خلص إليها ، ما يلي : زيادة الإنفاق الحكومي والإنفاق الاستهلاكي من شأنها أن تعيد النمو إلى الاقتصاد البريطاني في العام 2025 ، مما يساعده على التفوق على نظرائه الأوروبيين الأكثر عرضة لخطر عدم الاستقرار السياسي والحروب التجارية الجديدة."	OBJ
لكن الأسر لن تشعر بتحسن كبير ، حيث سيتباطأ نمو الأجور وسيعمل ارتفاع معدلات البطالة على تأجيج القلق.	SUBJ
الإجماع الواضح هو أن بريطانيا سوف تستمر في التخلف عن الاقتصاد الأميركي الأكثر ديناميكية ، وأن نمو الناتج المحلي الإجمالي سوف يكون بطيئا للغاية.	SUBJ
"تراجعات واضحة على الجانب الآخر ، يقول الخبير الاقتصادي ، أنور القاسم ، في تصريحات خاصة لموقع "" اقتصاد سكاي نيوز عربية "" إن الاقتصاد البريطاني يشهد تراجعات واضحة وسط تعقيدات اقتصادية متزايدة ، في وقت يعاني فيه من ارتفاع معدلات التضخم فوق الهدف المحدد ، واستقرار أسعار الفائدة عند مستويات مرتفعة ، بالإضافة إلى غياب مؤشرات نمو اقتصادي قوي."	OBJ
كما أن عدم وضوح الرؤية الاقتصادية العالمية يزيد من التحديات أمام بريطانيا ، ويجعلها في وضع اقتصادي حساس للغاية هذا العام.	SUBJ
ويختتم تصريحه بالتأكيد على أهمية اتخاذ إجراءات عاجلة وفعالة لدعم الاقتصاد وتعزيز الثقة بين الشركات والمستهلكين ، للتخفيف من وطأة التحديات التي تواجه البلاد في ظل بيئة اقتصادية معقدة.	OBJ
وبالتالي فإن هذه التحديات تتطلب استراتيجيات مرنة لمواكبة تأثيرات الأسعار على عمليات الإنتاج والنمو الاقتصادي.	SUBJ
التوقعات المتباينة تشير إلى أن آفاق الذكاء الاصطناعي في العام 2025 لا تزال غير مؤكدة.	OBJ
مع ذلك ، يؤكد العديد من المديرين التنفيذيين أن الطريقة التي يتفاعل بها الناس مع التكنولوجيا ستستمر في التغير في العام الجديد ، ومن المرجح أن يؤثر ذلك على الوظائف.	SUBJ
كل تمريرة وعناوين وإشعارات تم تصميمها بعناية فائقة لجذب انتباهنا.	SUBJ
"ويطبق البعض قواعد خاصة بهم أو بأطفالهم ، ويبحث آخرون عن بدائل مثل "" الهواتف الذكية "" التي لا تحتوي على متصفحات ويب."	SUBJ
فيما يتوقع الرئيس التنفيذي لشركة Hugging Face الناشئة في مجال الذكاء الاصطناعي ، كليمنت ديلانغ ، رد فعل أكثر عدوانية تجاه الذكاء الاصطناعي.	OBJ
"وكتب على موقع "" لينكد إن "" إن "" أول احتجاج عام كبير يتعلق بالذكاء الاصطناعي سيأتي في عام 2025 "" ، على حد وصفه."	OBJ
ويحدد خبير تكنولوجيا المعلومات ، في هذا السياق ، أبرز الاتجاهات المتوقعة : التوسع في الأتمتة وتحسين الإنتاجية : سيستمر الذكاء الاصطناعي في أتمتة العديد من المهام الروتينية والمتكررة ، مما سيمكن الشركات من تحقيق كفاءة أعلى وتخفيض تكاليف التشغيل.	OBJ
ومع ذلك ، قد يؤدي هذا إلى تقليص الوظائف التقليدية في مجالات مثل التصنيع والإدارة والخدمات اللوجستية.	SUBJ
ظهور فرص عمل جديدة : بينما تختفي بعض الوظائف ، ستظهر فرص عمل جديدة تتعلق بتطوير تقنيات الذكاء الاصطناعي وإدارتها وصيانتها.	OBJ
كما ستزداد الحاجة إلى المتخصصين في التعلم الآلي وتحليل البيانات وهندسة الأنظمة الذكية.	SUBJ
أهمية التعليم المستمر وإعادة التأهيل : سيصبح التكيف مع التحولات التكنولوجية ضرورة للعاملين في سوق العمل.	SUBJ
اتساع الفجوة في المهارات : من المتوقع أن تزداد الفجوة بين العاملين الذين يمتلكون مهارات تقنية متقدمة والذين يفتقرون إليها ، مما قد يؤدي إلى تزايد الفوارق الاقتصادية والاجتماعية.	OBJ
وسيتطلب ذلك مهارات جديدة للتفاعل مع الأنظمة الذكية والعمل بجانبها بفعالية.	SUBJ
كما يشير في الوقت نفسه إلى التحول في الصناعات الإبداعية ، إذ تشهد الصناعات الإبداعية تغييرات جذرية بفضل تقنيات الذكاء الاصطناعي التوليدي.	OBJ
ويعتقد خبير تكنولوجيا المعلومات بأن الذكاء الاصطناعي سيظل قوة محورية تشكل سوق العمل في المستقبل القريب.	SUBJ
"ويردف : "" المستقبل يكمن في الدمج بين مهارات البشر وتقنيات الذكاء الاصطناعي لتحقيق توازن بين الكفاءة التكنولوجية والإبداع الإنساني ، مع ضمان استدامة التقدم للجميع ""."	SUBJ
وهذه المكونات تمنح هذه التقنيات القدرة على التعلم باستمرار ومعالجة كميات كبيرة من البيانات ، ما يسهم في تحسين جودة النتائج والمخرجات بشكل ملحوظ.	SUBJ
ويختم الحارثي حديثه بالتأكيد على أن الجمع بين الذكاء الاصطناعي والرقابة البشرية هو المفتاح لتحقيق التوازن والاستفادة القصوى من هذه التقنيات ، مع الحفاظ على استقرار الأنظمة وسلامتها.	OBJ
رياح معاكسة لكن على الجانب الآخر ، ثمة رياح معاكسة قد تحد من تقدم وتوسع استخدام الذكاء الاصطناعي ، أبرزها القضايا الأخلاقية المتعلقة بالخصوصية والمراقبة ، حيث يثير الاستخدام المكثف للذكاء الاصطناعي مخاوف بشأن انتهاك حقوق الأفراد وسوء استخدام البيانات الشخصية.	OBJ
إضافة إلى ذلك ، فإن التحديات التقنية تتضمن تحسين قدرة النماذج الذكية على التعلم بفعالية وبأقل استهلاك للموارد ، وهو ما يتطلب استثمارات ضخمة في البنية التحتية.	OBJ
علاوة على ذلك ، يبقى التدخل التنظيمي والرقابي ضرورة لضمان الاستخدام الآمن والشفاف لهذه التكنولوجيا المتقدمة.	SUBJ
"كما يشير تقرير "" بيزنس إنسايدر "" إلى عامل آخر ، وهو تأثير الرسوم الجمركية التي ستفرضها إدارة الرئيس الأميركي المنتخب دونالد ترامب."	OBJ
ينقل التقرير عن الخبير الاقتصادي في مؤسسة LendingTree ، جاكوب تشانيل ، قوله : إن المستهلكين من المرجح أن يخضعوا لأسعار أعلى لسلعهم خلال فترة ولايته إذا نفذ ترامب تعهده.	SUBJ
كما ينقل في السياق ذاته عن المدير المالي لشركة البرمجيات ريميني ستريت ، مايكل بيريكا ، قوله إن الشركات قد تضطر إلى إجراء بعض التخفيضات للتعويض عن آثار التعريفات الجمركية.	OBJ
منذ لحظة ظهوره للعلن للمرة الأولى في نهاية عام 2022 ، برز الذكاء الاصطناعي التوليدي كقوة تقنية أثارت الدهشة على نطاق واسع في العالم ، لترسخ هذه التكنولوجيا مكانتها كأداة مبتكرة في عالم الأعمال خلال 2023 و2024.	OBJ
"وبحسب تقرير نشره موقع "" آكسيوس "" واطلع عليه موقع "" اقتصاد سكاي نيوز عربية "" ، فإنه مع دخول ثورة الذكاء الاصطناعي التوليدي عامها الثالث ، أصبحت هذه التكنولوجيا تتجاوز دورها كأداة للعمل ، لتتحول إلى شريك يومي ، لها رأي في مختلف جوانب الحياة الشخصية ، حيث تساعد الأفراد على تحليل أنظمتهم الغذائية ، وتشخيص الأمراض ، وتقديم النصائح الشخصية ، وترجمة المحادثات العائلية ، وحتى كتابة عهود الزواج ، واختيار الملابس المناسبة ، والمساعدة في التعامل مع مشاعر الحزن على فقدان الأحباب وتنظيم إجراءات التعازي."	OBJ
وتشكل هذه المجالات مجتمعة حوالي 26.	SUBJ
"8 بالمئة فقط من إجمالي استخدامات البرنامج ، في حين أن الجزء الأكبر من استخدامات "" Claude "" والتي تصل نسبتها إلى 73 بالمئة ترتبط وبطرق لا حصر لها ، بالعديد من الأمور التي لها علاقة بحياة الناس."	OBJ
"ووسط التوجه المتزايد على استخدام الذكاء الاصطناعي التوليدي في الحياة الشخصية ، تبرز الخصوصية كأحد أكبر التحديات والمخاطر في هذا المجال ، فبحسب تقرير نشرته شبكة "" CNBC "" واطلع عليه موقع "" اقتصاد سكاي نيوز عربية "" ، يحذر الخبراء من خطورة تجاهل الأفراد للتحذيرات التي تدعوهم إلى عدم مشاركة معلوماتهم الخاصة مع أدوات الذكاء الاصطناعي ، مما يشكل "" علامة حمراء "" تنذر بمخاطر كبرى محتملة."	OBJ
قفزة نوعية غيرت حياة البشر ما أسباب الثقة الذكاء الاصطناعي ؟	SUBJ
أخبار ذات صلة منوعات عام 2025.	SUBJ
فالشركات تستخدم البيانات التي يدخلها المستخدمون الى برامج الذكاء الاصطناعي لتدريب البرامج نفسها ، ومساعدتها على إنتاج محتوى جديد ، مؤكدة أن بعض الشركات لا تخفي هذا الأمر بل تعترف به.	SUBJ
"وتؤكد مستشارة الذكاء الاصطناعي المعتمدة من أكسفورد هيلدا معلوف ، في حديث لموقع "" اقتصاد سكاي نيوز عربية "" ، أن عام 2025 سيكون عام الإبداع التكنولوجي بامتياز."	OBJ
وترى معلوف أن التحدي الأكبر سيكون في كيفية إدارتنا لهذه التكنولوجيا بشكل مسؤول ، بحيث نستفيد من مزاياها دون أن نخسر التوازن الإنساني في التعامل معها	SUBJ
شهدت أسواق النفط في العام 2024 تقلبات حادة ، عكست حجم الضغوطات التي تواجه السوق العالمية أمام سلسلة من التحديات المتلاحقة.	OBJ
ومن ثم فإن التوترات الجيوسياسية التي عادة ما تدعم الأسعار لم تكن كافية لتحفيز انتعاش ملحوظ ، وهو ما جعل السوق تعيش حالة من الارتباك أمام توقعات متضاربة.	OBJ
ومع استمرار الضبابية ، يبقى مستقبل أسعار النفط رهن التطورات الاقتصادية والجيوسياسية القادمة.	SUBJ
تراجعت خام برنت - عند التسوية - في نهاية 2024 نحو 3 % بالمئة مقارنة بسعر التسوية في نهاية 2023 البالغ 77.	OBJ
04 دولار للبرميل ، في حين لم يشهد سعر خام غرب تكساس الوسيط تغيرا يذكر تقريبا مقارنة بسعر التسوية نهاية العام الماضي.	OBJ
هذا التراجع هو الانخفاض السنوي الثاني على التوالي.	SUBJ
يأتي ذلك بعد توقف تعافي الطلب بعد كورونا ، والتحديات التي تجابه الاقتصاد الصيني.	OBJ
"ضخ الولايات المتحدة ومنتجين آخرين من خارج أوبك المزيد من الخام في السوق العالمية وفيرة الإمدادات ، أسهم في تراجع النفط ، بحسب تحليل نشرته "" رويترز ""."	OBJ
في شهر سبتمبر الماضي ، أنهت العقود الآجلة لخام برنت التعاملات دون 70 دولارا للبرميل للمرة الأولى منذ ديسمبر 2021.	OBJ
خلال 2024 ، جرى تداول خام برنت على نطاق واسع دون أعلى مستوياته التي سجلها في السنوات القليلة الماضية مع تلاشي انتعاش الطلب بعد الجائحة وصدمات الأسعار الناجمة عن الحرب في أوكرانيا في 2022.	OBJ
يشار إلى أن العقود الآجلة لخام برنت ارتفعت 65 سنتا أو 0.	OBJ
64 دولار للبرميل عند التسوية يوم الثلاثاء ( وهو آخر أيام التداول في 2024 ) ، كما ارتفعت العقود الآجلة لخام غرب تكساس الوسيط الأميركي 73سنتا أو 1.	OBJ
"عوامل رئيسية من لندن ، يقول خبير اقتصاديات الطاقة ، نهاد إسماعيل ، في تصريحات خاصة لموقع "" اقتصاد سكاي نيوز عربية "" : خلال العام 2024 واجهت أسواق النفط تحديات وظروف صعبة ؛ بما في ذلك تأثير الاضطرابات الجيوسياسية في الشرق الأوسط واستمرار الحرب بين روسيا وأوكرانيا."	OBJ
لكن اللافت أنه رغم التوترات والحروب واضطراب الملاحة في البحر الأحمر إلا أن الأسعار بقيت تتأرجح ضمن نطاق ضيق.	SUBJ
من العوامل التي كبحت ارتفاع الأسعار هو ضعف الطلب الصيني (.	SUBJ
) رغم أن شركات النفط الصينية الوطنية الكبرى CNPC و SINOPEC تتوقعان نمو الطلب إلى 16 مليون برميل يوميا بحلول 2027.	OBJ
وهذا توقع غير واقعي في ظل نمو الطلب على السيارات الكهربائية.	SUBJ
لكن السوق النفطية تقر وتعترف بأن الصين تبقى المحرك الرئيس لنمو الطلب وأسعار النفط.	SUBJ
فيما S & P Global تتوقع أن نمو الطلب العام 2025 سيأتي من الهند وكوريا الجنوبية.	OBJ
"مع استلام دونالد ترامب البيت الأبيض وسياسة تشجيع الإنتاج النفطي ؛ السؤال : "" هل كي فستكون سياسة ترامب مع احتمال تواجد فائض نفطي في السوق ؟"	OBJ
""" هل سيقوم ترامب بتشديد العقوبات على إيران وفنزويلا ؟"	OBJ
وأيضا يهدد ترامب بفرض جمارك عقابية على الصين والاتحاد الأوروبي وكندا والمكسيك.	OBJ
ما تأثير ذلك على أسعار النفط والمشتقات ؟	SUBJ
ويستطرد : من الطبيعي أن يسعى الرئيس الأميركي لتقديم خدمة كبيرة لشركات النفط الأميركية ، ولكن هناك تطورات قد تؤذي تلك الشركات.	SUBJ
""" ICIS "" : أي تصعيد بالحرب الروسية الأوكرانية سينعكس على النفط بحسب رويترز ، لا يزال بعض المحللين يرون أن العرض قد يتقلص في 2025 اعتمادا على سياسات الرئيس الأميركي المنتخب دونالد ترامب ، بما في ذلك تلك المتعلقة بالعقوبات."	OBJ
"وقال المحلل في برايس فيوتشرز غروب فيل فلين : "" في ظل احتمال تشديد العقوبات على النفط الإيراني مع عودة ترامب ، فإننا نتوقع سوق نفط أكثر شحا في العام الجديد "" ، مشيرا أيضا إلى الطلب الهندي القوي وبيانات تفيد بنمو نشاط التصنيع في الصين."	OBJ
ثمة تساؤلات عديدة ؛ من بينها : هل سينجح ترامب في حل الصراعات بين روسيا واوكرانيا وفي الشرق الأوسط ؟	SUBJ
وإذا تمكن من ذلك سيساعد روسيا في رفع وتيرة التصدير وزيادة المعروض في السوق وهذا يسهم في بقاء الأسعار منخفضة.	SUBJ
"وستستمر حالة عدم اليقين خلال 2025 وسط تجاذبات متضادة ""."	SUBJ
ما الذي ينتظر أسعار النفط في 2025 ؟	SUBJ
"وكانت منظمة الدول المصدرة للنفط "" أوبك "" ، قد خفضت توقعاتها لنمو الطلب العالمي على النفط خلال العام 2025 بواقع 90 ألف برميل يوميا ، ليصل إلى 1."	OBJ
4 مليون برميل يوميا خلال العام المقبل.	OBJ
تتوقع وكالة الطاقة الدولية أن سوق النفط ستدخل عام 2025 بفائض حتى بعد أن أرجأت أوبك وحلفاؤها خطتهم لبدء زيادة الإنتاج حتى أبريل 2025 على خلفية انخفاض الأسعار.	OBJ
بين زيادة الإنتاج وكبح الأسعار تشير توقعات الوكالة إلى فائض يبلغ 950 ألف برميل يوميا في 2025 - أي ما يعادل حوالي واحد بالمئة من الإنتاج العالمي - على الرغم من تمديد أوبك + التي تضم منظمة البلدان المصدرة للبترول وحلفاء مثل روسيا لتخفيضات الإنتاج حتى أبريل 2025.	OBJ
ومن بين أبرز العوامل التي يترقبها المتعاملون في 2025 ، احتمالات خفض الفيدرالي الأميركي لأسعار الفائدة في عام 2025 بعد أن توقع صناع السياسات في المجلس في وقت سابق من الشهر خفضها بوتيرة أبطأ بسبب ارتفاع التضخم.	OBJ
ومن شأن انخفاض أسعار الفائدة أن يؤدي إلى تحفيز النمو الاقتصادي بشكل عام مما يعزز بدوره الطلب على النفط.	SUBJ
المخاطر الجيوسياسية المتبقية من العام 2024 ، واتساع نطاق النزاعات ، ستواصل تأثيرها الكبير على الأسواق العالمية في العام الجديد.	OBJ
"الأسواق باتت تتعامل مع الصدمات بشكل غير مباشر ، مع استمرار جهود "" أوبك بلس "" لتحقيق التوازن من خلال تخفيضات طوعية للإنتاج."	SUBJ
وتوقعت أن عدم التوافق في السوق ، لا سيما مع عودة الرئيس الأميركي دونالد ترامب إلى واجهة المشهد السياسي ، قد يسبب صدمات إضافية.	OBJ
هذا التدخل اللافت من شخصية عالمية مشهورة بتأثيرها في مجالات التكنولوجيا والاقتصاد يسلط الضوء على أبعاد جديدة للعلاقة بين الاقتصاد والسياسة ، خاصة عندما يمتد نفوذ قادة الأعمال إلى المشهد السياسي الدولي.	OBJ
"لم يقتصر دعم ماسك على تغريدة عابرة عبر منصته "" X "" ، بل تجاوزه إلى مقال رأي نشره في إحدى الصحف الألمانية ، يؤكد فيه موقفه الذي فتح الباب أمام تساؤلات حول دوافعه الحقيقية."	SUBJ
وما بين الانتقادات الحادة من الأحزاب الألمانية التقليدية وبعض المواقف الداعمة التي تبرر تدخله باعتباره رأي مشروع من مستثمر مهم في البلاد ، تكشف هذه الخطوة عن انقسامات داخل ألمانيا حول تأثير الأفراد ذوي النفوذ العالمي في السياسة المحلية.	OBJ
"هل يمكن أن يعزز من فرص حزب "" البديل "" أم أنه سيؤدي إلى نتائج عكسية تسلط الضوء على الانقسام السياسي في البلاد ؟"	OBJ
ماسك ، الذي كان له دور فاعل في الساحة السياسية الأميركية من خلال دعمه للرئيس دونالد ترامب ، قرر الآن التدخل في السياسة الألمانية بطريقة أثارت انقسامات واسعة.	SUBJ
"بدأ ماسك بإعلان دعمه للحزب اليميني عبر تغريدة على منصة "" X "" ، التي يمتلكها ، قال فيها إن حزب البديل وحده "" قادر على إنقاذ ألمانيا ""."	SUBJ
كما هاجم سياسيون ألمان ماسك.	SUBJ
الحزب يعارض السيارات الكهربائية ، وهو ما يتعارض مع مصالح ماسك وتوجهاته كرائد في صناعة السيارات الكهربائية.	SUBJ
كما يشير إلى أن هناك أصوات في ألمانيا تدعو إلى استدعاء السفير الأميركي للاحتجاج على هذه التصريحات باعتبارها تدخل في الشؤون الداخلية.	SUBJ
ومع ذلك ، يرى البعض أنه من الأفضل الانتظار حتى تبدأ الإدارة الأميركية الجديدة عملها بشكل رسمي.	SUBJ
"ويضح عمار أنه قد تدفع تصريحات ماسك البعض إلى دعم حزب "" البديل "" ، في حين قد يتراجع آخرون عن دعمه بسبب التدخل الأميركي."	SUBJ
"موقف ماسك الكاتب الصحافي المتخصص في العلاقات الدولية من برلين ، محمد الخفاجي ، يقول في تصريحات خاصة لموقع "" اقتصاد سكاي نيوز عربية "" إن أسباب دعم إيلون ماسك لحزب البديل من أجل ألمانيا قد تكون نتيجة مزيج من العوامل الاقتصادية والثقافية ، التي تعكس اهتماماته الشخصية وأيديولوجياته."	OBJ
يرى ماسك أن السياسات البيئية ، بما في ذلك التنظيمات المتعلقة بالطاقة الخضراء ، تعرقل الابتكار الصناعي.	SUBJ
كما أن موقفه قد يؤدي إلى تغطية إعلامية أوسع للحزب وبرامجه.	SUBJ
المستشار الألماني يخسر ثقة البرلمان لكن على الجانب الآخر ، يشير إلى أن : دعم ماسك لحزب قد يدفع الناخبين المعتدلين والوسطيين إلى تعزيز موقفهم ضد الحزب.	SUBJ
الأحزاب التقليدية استغلت دعم ماسك للهجوم على حزب البديل من أجل ألمانيا ، مدعية أن الحزب يخدم مصالح الرأسمالية الأجنبية وليس مصالح الشعب الألماني.	SUBJ
في مقابلة جريئة مع سكاي نيوز عربية ، تناول الفنان السوري بشار إسماعيل مواقفه تجاه التغيرات السياسية في سوريا بعد سقوط النظام.	OBJ
"ويقول إسماعيل : "" كان شغلنا أن نصفق لحتى نحمي حالنا من السجون ، أما التفكير فهو ممنوع."	SUBJ
""" رغم سعادته بسقوط النظام ، يؤكد إسماعيل أن المرحلة القادمة تتطلب العمل الجاد والتخطيط لبناء سوريا جديدة."	SUBJ
"يصرح : "" الاحتفال بالثورة لا يكفي."	SUBJ
حان الوقت لنفكر ، لنضع الخطوط العريضة لسوريا الحديثة.	SUBJ
""" وشدد على ضرورة وضع دستور يضمن حقوق جميع الأطياف وتحقيق العدالة دون الانجرار إلى الانتقام."	SUBJ
"يقول : "" لا نريد أن نصنع طغاة جدد."	SUBJ
العبيد هم من يصنعون الطغاة ، وإذا استمر التصفيق الأعمى سنكرر أخطاء الماضي.	SUBJ
""" ودعا إلى إشراك جميع أطياف المجتمع في العملية السياسية لضمان بناء دولة تعددية تحترم الجميع."	SUBJ
نحتاج إلى عقول واعية وقلوب مفعمة بالحب لبناء دولة قوية وعادلة تحتضن الجميع دون تمييز.	SUBJ
""" وأضاف بحماس : "" إذا بدأنا بالتفكير والعمل ، يمكننا أن نبني سوريا التي نحلم بها."	SUBJ
أثار الإعلان عن أبرز التعديلات التي يتوقع إدخالها على مدونة الأسرة ( قانون الأحوال الشخية ) جدلا ونقاشا واسعا في المغرب.	OBJ
ويكتسي موضوع تعديل مدونة الأسرة أهمية كبرى في المملكة ، حيث تعتبر المدونة بمثابة إصلاح رئيسي في تنظيم العلاقات الأسرية وحماية حقوق الأفراد.	SUBJ
وتم إقرار مدونة الأسرة في المغرب سنة 2004 ، وهي تشمل القوانين التي تنظم الزواج والطلاق والنفقة والحضانة والحقوق الزوجية بشكل عام ، وغيرها.	OBJ
وفي سبتمبر 2023 ، وجه العاهل المغربي الملك محمد السادس ، الحكومة لإعادة النظر في مدونة الأسرة ، بعد سنوات من مطالبات جمعيات نسائية بإدخال إصلاحات عليها بما يتماشى مع التطورات الاجتماعية والحقوقية.	OBJ
139 مقترح تعديل وكشف وزير العدل عبد اللطيف وهبي ، خلال لقاء تواصلي في الرباط ، الثلاثاء ، عن أبرز التعديلات المقترحة لمراجعة مدونة الأسرة ، التي عقدت بشأنها جلسة عمل ملكية ، الإثنين.	OBJ
وأوضح وهبي أن التعديلات اعتمدت بناء على مقترحات الهيئة المكلفة ورأي المجلس العلمي الأعلى ، وأضاف أن الهيئة قدمت 139 مقترح تعديل ، تغطي جميع جوانب المدونة.	SUBJ
أخبار ذات صلة تعدد الزوجات ومن أبرز التعديلات المقترحة تلك المتعلقة بتعدد الزوجات ، حيث سيتم إلزام الزوج بأخد رأي الزوجة عند توثيق عقد الزواج الثاني ، لتحديد ما إذا كانت تشترط عدم الزواج عليها ، وفي حال تضمين هذا الشرط في العقد فلا يمكن للزوج التعدد.	OBJ
وفي حال عدم وجود هذا الشرط ، فإن التعدد سيكون مقصورا على حالات استثنائية ، مثل إصابة الزوجة الأولى بالعقم ، أو مرض يمنع المعاشرة الزوجية ، أو حالات أخرى يحددها القاضي وفق معايير قانونية موضوعية.	OBJ
الحضانة والخطبة وفيما يتعلق بالحضانة ، فقد اقترح التعديل الجديد منحها بشكل مشترك للزوجين أثناء زواجهما ، مع إمكانية استمرار هذا الحق بعد الطلاق في حال اتفق الطرفان.	OBJ
كما تم تعزيز حق الأم المطلقة في حضانة أطفالها ، حتى في حال زواجها مجددا ، وضمان حقها في سكن المحضون ، وفقا لما أعلنه وزير العدل.	OBJ
وتضمنت التعديلات أيضا تنظيم ضوابط جديدة لزيارة المحضون أو السفر به ، بما يضمن مصلحة الطفل.	SUBJ
ومن جانب آخر ، تم اقتراح تقليص مدة البت في قضايا الطلاق إلى 6 أشهر كحد أقصى.	OBJ
كما تنص تعديلات المدونة المقترحة على توثيق الخطبة واعتماد العقد كأداة رئيسية لإثبات الزواج ، مع تحديد الحالات الاستثنائية التي يمكن فيها الاستناد إلى سماع دعوى الزيجة.	OBJ
أخبار ذات صلة المغرب يتجه لتعديل مدونة الأسرة.	SUBJ
ما أبرز الإصلاحات المطلوبة ؟	SUBJ
"أما فيما يتعلق بالإرث ، فقد تم "" اعتماد مقترح المجلس العلمي الأعلى المتعلق بإرث البنات "" ، الذي يتيح إمكانية هبة الأموال للوارثات على قيد الحياة ، مع اعتبار الحيازة الحكمية كافية."	OBJ
كما ينص التعديل الجديد على فتح المجال أمام الوصية والهبة بين الزوجين في حالات اختلاف الديانة.	OBJ
تعديلات مهمة ورحبت رئيسة جمعية التحدي والمساواة بشرى عبدو ، بالتعديلات المقترحة على مدونة الأسرة ، معتبرة إياها خطوة إيجابية نحو تحقيق عدد من المطالب المهمة.	OBJ
"وأشارت عبدو في تصريح لموقع "" سكاي نيوز عربية "" ، إلى أن التعديلات أجابت على قضايا عدة ، أبرزها تمكين الأم الحاضنة من النيابة القانونية على أطفالها ، وإلغاء إسقاط حضانتها لهم في حال زواجها."	OBJ
ولفتت أيضا إلى أهمية خطوة اعتبار عمل الزوجة المنزلي مساهمة في تنمية الأموال المكتسبة خلال قيام الزواج ، وهو ما يعد تقدما في الاعتراف بدور المرأة في الأسرة.	OBJ
وفيما يتعلق بالطلاق ، أكدت عبدو أهمية التعديل الذي يميز بين الطلاق الاتفاقي والشقاق ، حيث سيتم النص عليهما بشكل واضح في القانون ، بدلا من تعدد أنواع الطلاق والإجراءات القانونية المعقدة التي كانت تثقل كاهل النساء والرجال على حد سواء.	OBJ
كما أشادت عبدو بقرار إحداث هيئات للوساطة والصلح بهدف معالجة النزاعات الزوجية قبل اللجوء إلى القضاء وطلب الطلاق ، معتبرة إياها خطوة مهمة نحو تقليل التوترات بين الأزواج وتسهيل تسوية النزاعات.	OBJ
"ومع ذلك ، أشارت عبدو إلى "" بعض النقاط التي لم تحظ بالاهتمام الكافي في التعديل "" من وجهة نظرها ، مثل عدم منع تعدد الزوجات بشكل واضح ، وعدم أخذ الخبرة الجينية كشرط أساسي لإثبات النسب ، فضلا عن مسألة التوارث بين الأزواج من ديانات مختلفة."	OBJ
"أخبار ذات صلة "" بغاتها الوقت ""."	SUBJ
حملة نسائية في المغرب للمطالبة بالمناصفة المغرب.	SUBJ
"وأوضحت الطاهري في تصريح لموقع "" سكاي نيوز عربية "" ، أن من أبرز هذه التعديلات الولاية المشتركة بين الأبوين ، والاستغناء عن شرط الشهود المسلمين في حالات زواج المغاربة المقيمين في الخارج ، بالإضافة إلى إيقاف بيت الزوجة عن الدخول في التركة من خلال الاحتفاظ بالبيت للزوج الآخر في حال وفاة أحد الزوجين."	OBJ
"وقالت الطاهري إن هذه التعديلات "" تمثل جزءا من مطالب الحركة الحقوقية والنسائية ، التي تسعى إلى تحسين وضعية المرأة وضمان حقوقها بشكل أكبر ""."	SUBJ
وأشارت إلى ضرورة الالتزام بما جاء في بلاغ الديوان الملكي ، خاصة ما يتعلق بضمان المساواة والتضامن ، والالتزام بالاتفاقيات الدولية التي صادق عليها المغرب في مجال حقوق الإنسان.	OBJ
وشددت على أهمية صياغة هذه التعديلات في مواد قانونية دقيقة وواضحة ، بحيث تكون قابلة للتنفيذ المباشر دون الحاجة إلى تدخلات أو تعقيدات قانونية.	SUBJ
إلا أن هذا التطور السريع يأتي مع تحديات معقدة تتراوح بين التنظيمية والاقتصادية ، مما يطرح تساؤلات حول كيفية ضمان الاستخدام الأمثل لهذه التكنولوجيا.	SUBJ
وعلى الرغم من الوعود الكبيرة التي يحملها الذكاء الاصطناعي ، إلا أن تزايد المخاوف من تأثيراته على الأمن الرقمي ، الخصوصية ، والتوظيف يضع الضغوط على الحكومات والشركات لتطوير سياسات تنظيمية فعالة تواكب هذه الثورة التقنية.	OBJ
أخبار ذات صلة أخبار روسيا مع هذه الدول.	SUBJ
روسيا تؤسس تحالفا في قطاع الذكاء الاصطناعي خاص الاحتيال المالي يتفاقم.	SUBJ
هل تستطيع البنوك الصمود بمفردها ؟	SUBJ
وفي هذا السياق ، من المتوقع أن يتباطأ الابتكار السريع في الذكاء الاصطناعي في المستقبل القريب لصالح مرحلة من التحسين والتطوير المستمر للنماذج القائمة.	OBJ
ومن شأن هذا التوجه أن يكون أكثر ملاءمة لتحقيق توازن بين الابتكار والاستدامة الاقتصادية ، من خلال تركيز الجهود على تحسين النماذج الحالية وتوسيع نطاق استخدامها في قطاعات متنوعة.	SUBJ
ما المتوقع للعام 2025 ؟	SUBJ
وفق بيتشاي ، فإن الذكاء الاصطناعي التوليدي ، الذي أصبح محط أنظار العالم بعد إطلاق ChatGPT من OpenAI قبل عامين ، قد اجتذب انتباه المستخدمين حول العالم.	OBJ
""" أعتقد بأن التقدم سيكون أكثر صعوبة."	SUBJ
عندما أنظر إلى العام 2025 ، فالفرص السهلة قد انتهت.	SUBJ
"وأكد بيتشاي أن النماذج اللغوية الحالية ، مثل ChatGPT وجيميني من جوجل وLlama من ميتا ، ستستمر في التحسن بشكل تدريجي ، خاصة في مجالات مثل "" التفكير ، وإكمال سلسلة من الإجراءات بشكل أكثر موثوقية ""."	OBJ
وأشار بيتشاي إلى أن التغييرات الجذرية التي قد تعيد صياغة الطريقة التي يفكر بها معظم الناس حول الذكاء الاصطناعي لن تحدث في العام المقبل.	SUBJ
ويشارك بعض الرؤساء التنفيذيين في شركات التكنولوجيا مثل ساتيا ناديلا ، الرئيس التنفيذي لشركة مايكروسوفت ، رأي بيتشاي.	OBJ
وهذه أبرز مزاياها ومع ذلك ، يعارض بعض قادة الصناعة هذا الرأي بشكل علني.	SUBJ
التشريعات والتنظيمات : شددت الحكومات ، خاصة في أوروبا ، القوانين المتعلقة بالذكاء الاصطناعي ، مما أوجب على الشركات مثل غوغل ومايكروسوفت العمل على الامتثال التنظيمي ، ما يؤدي إلى إبطاء الابتكارات.	OBJ
المخاوف المجتمعية : تصاعد القلق من تأثير الذكاء الاصطناعي على البطالة ، الأمن الاجتماعي ، والأمان الرقمي ، مما دفع إلى نقاشات أخلاقية أكثر شمولية.	OBJ
التحديات الاقتصادية : مع ارتفاع تكاليف الطاقة وتزايد الضغوط الاقتصادية ، باتت الشركات تعيد النظر في أولويات الاستثمار ، مركزة على المشاريع ذات العائد المضمون.	SUBJ
التوجه نحو التطبيقات العملية : تحول التركيز من الابتكار إلى الاستخدامات الواقعية ، مثل التطبيقات الطبية والصناعية التي تخدم المجتمع بشكل مباشر.	OBJ
أخبار ذات صلة أخبار الصين حرب الرقائق تشتعل.	SUBJ
"ويأتي ذلك في ظل إعلان "" أوبن أيه آي "" عن تحولها إلى شركة ربحية ، وهو ما يسلط الضوء على التحديات التي تواجه الشركات في تحقيق التوازن بين الابتكار وتحقيق العوائد للمستثمرين."	OBJ
استقرار مرحلي أم ضغوط دولية l 29 نوفمبر 2024 - 12 : 44 بتوقيت أبوظبي سكاي نيوز عربية - أبوظبي شهدت التطورات الأخيرة في لبنان خطوة هامة تمثلت في توقيع اتفاق هدنة بين إسرائيل وحزب الله ، بضمانات أميركية ودولية.	OBJ
الاتفاق الذي يهدف إلى إنهاء التصعيد على الحدود الجنوبية للبنان يثير تساؤلات عميقة حول مستقبله ، ومدى تأثير هذه الضمانات على سيادة الدولة اللبنانية ودور القوى الإقليمية في المشهد السياسي.	OBJ
الظهيرة على سكاي نيوز عربية ، ناقش هذه التطورات مع الكاتب والباحث السياسي رضوان عقيل ، والباحث في الشؤون السياسية والقانونية ، مجد حرب.	OBJ
استهل النقاش بتسليط الضوء على الدور الأميركي في ضمان الالتزام بالهدنة ، وتم التساؤل عن مدى تأثير هذا الدور على الاستقرار الداخلي في لبنان.	OBJ
رضوان عقيل أكد أن الدور الأميركي يهدف إلى تحقيق استقرار مرحلي ، لكنه أشار إلى أن بعض بنود الاتفاق قد تثير مخاوف بشأن المساس بالسيادة اللبنانية.	SUBJ
"لكن لا يمكننا تجاهل أن بعض الأطراف الداخلية قد تستغل هذا الاتفاق لتعزيز أجنداتها السياسية ""."	SUBJ
"وقال : "" حزب الله يواجه تحديات غير مسبوقة ، سواء من الداخل اللبناني أو من المجتمع الدولي ، فالاتفاق يعكس رضوخه لضغوط كبيرة ، لكن هذا لا يعني انتهاء دوره كقوة فاعلة في المعادلة السياسية والعسكرية ""."	OBJ
"ولكن من الواضح أن هناك تحولات في استراتيجيته بعد هذا الاتفاق ""."	SUBJ
"وقال : "" النفوذ الإيراني في لبنان يرتبط بشكل مباشر بحزب الله."	SUBJ
"إذا تمكنت الولايات المتحدة من تثبيت الهدنة وتقييد حركة الحزب ، فقد يؤدي ذلك إلى تراجع التأثير الإيراني ""."	SUBJ
"بينما اعتبر مجد حرب أن الاتفاق قد يكون فرصة لإعادة تقييم الدور الإيراني في لبنان ، وقال : "" إيران كانت تراهن على استخدام لبنان كورقة ضغط في مفاوضاتها مع الغرب."	OBJ
مجد حرب أشار إلى أن الاتفاق قد يساعد في تخفيف التوترات السياسية ، لكنه نبه إلى أن أي تسوية لا تشمل جميع الأطراف لن تكون مستدامة.	SUBJ
"وقال : "" انتخاب رئيس جديد يجب أن يتم بالتوافق بين جميع القوى السياسية."	SUBJ
"أي محاولة لفرض مرشح معين قد تؤدي إلى تعقيد المشهد أكثر ""."	SUBJ
فيما أكد رضوان عقيل أن لبنان بحاجة إلى استغلال هذه الهدنة لإعادة ترتيب أولوياته السياسية والاقتصادية.	SUBJ
"وقال : "" المجتمع الدولي ينظر إلى لبنان كدولة تحتاج إلى استقرار سياسي طويل الأمد."	SUBJ
"يجب أن نغتنم هذه الفرصة للعمل على إصلاحات جذرية تعيد الثقة بالمؤسسات ""."	SUBJ
الضمانات فرصة قد تتحول إلى نقمة الجدير بالذكر أن ضمانات التهدئة الأميركية تمثل فرصة مهمة للبنان للخروج من دائرة الحرب ، لكن هذه الفرصة قد تتحول إلى نقمة إذا لم يتم استثمارها في تعزيز السيادة الوطنية وتحقيق توافق داخلي بين الأطراف المتصارعة.	OBJ
وأشارت اللجنة إلى أن هذا الرقم يزيد بمقدار مليار دولار عن خسائر الاحتيال المسجلة في 2022 ، رغم استقرار عدد التقارير عند نحو 2.	OBJ
6 مليار دولار في 2022 ، بحسب اللجنة.	OBJ
رجحت اللجنة أن تكون الخسائر الفعلية لكبار السن أعلى بكثير ، لتصل إلى نحو 62 مليار دولار في 2023 ، وذلك بسبب عدم الإبلاغ عن كثير من الحالات.	OBJ
كبار السن كانوا أكثر عرضة بنسبة 60 بالمئة مقارنة بصغار السن لخسائر تفوق 100, 000 دولار العام الماضي.	OBJ
من الضرورة بمكان التوسع في توفير برامج شرح مبسط لهم حول كيفية استخدام خدماتهم البنكية بأمان.	SUBJ
لذا ، من الضروري وجود شخص موثوق من الأسرة لمساعدتهم على إدارة أمورهم المالية ، مع التأكيد على أهمية اختيار هذا الشخص بعناية لضمان حماية الحسابات من المخاطر.	SUBJ
كما حذرت رمسيس من أن كبار السن هم الفئة الأكثر عرضة للاحتيال في جميع أنحاء العالم ، خاصة مع تراجع القدرات الذهنية لدى بعضهم.	OBJ
لذا ، ينبغي أن تكون الأسرة على وعي تام بمخاطر الأشخاص المحيطين بكبار السن ، مثل العاملين في المنزل أو الممرضين.	SUBJ
كما طالبت بأن تتبع البنوك سياسة إخطار العميل فور حدوث أي تحركات غير معتادة في الحسابات.	SUBJ
وأشارت إلى أن مسؤولية حماية كبار السن من المخاطر المالية هي مسؤولية مشتركة بين البنوك والأسر ، وتشمل كل التعاملات المالية ، بما في ذلك التداول في البورصة والعقود الاستثمارية.	OBJ
وشددت على ضرورة تبني استراتيجيات شاملة لضمان أمان وسلامة تعاملاتهم المالية.	SUBJ
استخدام كلمات مرور قوية وآمنة ، والتأكد من أن المواقع التي يتم التعامل معها محمية.	SUBJ
من المهم لكبار السن استشارة أحد أفراد العائلة أو شخص موثوق عند تلقي عروض أو طلبات مشبوهة ، خاصة المتعلقة بالمال.	SUBJ
الإبلاغ يساعد في حماية المجتمع ككل من هذه التهديدات.	SUBJ
"وأضاف : "" الحذر والتوعية هما خط الدفاع الأول."	SUBJ
"وأشدد على أهمية عدم التسرع في اتخاذ أي قرارات مالية بدون استشارة أو التحقق من مصدر الطلب ""."	SUBJ
رصدت سكاي نيوز عربية آراء بعض المواطنين في عدد من الدول العربية بشأن الانتخابات الرئاسية الأميركية ، المقررة يوم الخامس من نوفمبر الجاري ، وتأثيرها عليهم.	OBJ
وجاء رصد سكاي نيوز عربية لآراء مواطنين من فلسطين ولبنان والعراق ومصر ، وتباينت آراء كثيرين من مواطني هذه الدول بشأن الفائز المحتمل بين الديمقراطية كامالا هاريس أو الجمهوري دونالد ترامب في هذه الانتخابات.	OBJ
في قطاع غزة ، توقع البعض فوز كامالا هاريس مرشحة الحزب الديمقراطي على ترامب ، معتبرين أن الحزب الجمهوري لطاما كان في سياساته داعما بشكل كامل لإسرائيل إزاء الصراع الفلسطيني الإسرائيلي.	OBJ
فيما قال البعض الآخر إنهم لا يعولون على الولايات المتحدة أبدا في وقف الحرب المستمرة في غزة وإيجاد حل دائم للصراع.	SUBJ
أما في رام الله ، فقال الفلسطينيون إنه لا فرق في سياسة الديمقراطي أو الجمهوري بشأن قضيتهم ، مضيفين أن الولايات المتحدة مع اختلاف رئيسها تدعم إسرائيل بشكل كامل.	SUBJ
وفي لبنان ، عبر غالبية اللبنانيين عن عدم اكتراثهم للانتخابات وعدم تفاؤلهم بحدوث أي تغيير إيجابي على واقعهم خاصة في ظل الحرب الدائرة مع إسرائيل ، بسبب خذلان واشنطن المستمر للبنان.	OBJ
وقال اللبنانيون إنهم لا يكترثون لنتائج الانتخابات الرئاسية الأميركية ، مضيفين أنهم فقدوا ثقتهم بواشنطن وبنواياها لمساعدتهم خاصة في ظل الحرب.	SUBJ
أما في العراق ، فقد تباينت الآراء بين من يتوقع فوز دونالد ترامب أو كامالا هاريس.	SUBJ
وفي مصر أيضا تباينت الآراء حول النتائج المتوقعة للانتخابات الرئاسية الأميركية ، حيث تمنى الشارع المصري من الرئيس المقبل للولايات المتحدة إيقاف الحرب في المنطقة وإحلال السلام في الشرق الأوسط.	OBJ
ومن خلال اللقاءات ، تبين أن الفلسطينيين يميلون إلى عدم الاهتمام بالنتائج ، معتبرين أن لا فرق في سياسة الحزبين الديمقراطي والجمهوري بشأن القضية الفلسطينية.	SUBJ
ففي رام الله ، قال الفلسطينيون إنه لا فرق في سياسة الديمقراطي أو الجمهوري بشأن قضيتهم.	SUBJ
وقالوا أيضا إن الولايات المتحدة مع اختلاف رئيسها تدعم إسرائيل بشكل كامل.	SUBJ
أما في قطاع غزة ، فتتباين مواقف الفلسطينيين حيال انعكاس نتائج الانتخابات الأميركية ومدى قدرة الرئيس القادم على وقف الحرب الإسرائيلية على القطاع.	OBJ
فقد توقع البعض فوز كامالا هاريس مرشحة الحزب الديمقراطي على الجمهوري دونالد ترامب.	OBJ
واعتبر أهالي القطاع أن الحزب الجمهوري لطالما كان في سياساته داعما بشكل كامل لإسرائيل إزاء الصراع الفلسطيني الإسرائيلي.	SUBJ
وقال فلسطينيون إن سياسات ترامب كانت معادية لهم وفشلت بإيجاد حل للصراع.	SUBJ
فيما قال البعض إنهم لا يعولون على الولايات المتحدة أبدا في وقف الحرب المستمرة في غزة وإيجاد حل دائم للصراع.	SUBJ
يتجه الأميركيون هذا الأسبوع إلى صناديق الاقتراع لاختيار رئيسهم المقبل ، وسط تنافس حاد سيحدد ملامح السياسة الداخلية والخارجية للبلاد ، ويؤثر بشكل كبير على مستقبل الاقتصاد والأسواق العالمية.	OBJ
"وبحسب تقرير أعدته "" فايننشال تايمز "" واطلع عليه موقع "" اقتصاد سكاي نيوز عربية "" ، فإن رقم "" ربع تريليون دولار "" يرجع إلى السياسات الضريبية المختلفة للمرشحين كامالا هاريس ودونالد ترامب ، ويعتمد على تقديرات مصرف غولدمان ساكس ، الذي أشار إلى أن اقتراح ترامب بخفض معدل ضريبة الشركات من 21 في المئة إلى 15 في المئة في حال فوزه ، من شأنه أن يضيف 4 بالمئة إلى أرباح مؤشر "" ستاندرد آند بورز 500 "" ، في حين أن خطة هاريس لرفع ضريبة الشركات ، من 21 في المئة إلى 28 في المئة ، إضافة إلى مقترحاتها الضريبية الأخرى على الشركات ، من شأنها أن تقلل الأرباح بنسبة 8 في المئة."	OBJ
"وفي الوقت الذي يتوقع فيه أن تبلغ أرباح مؤشر "" ستاندرد آند بورز 500 "" نحو 2."	OBJ
كما قام ترامب بإيقاف فرض الضرائب على الأرباح التي تحققها الشركات الأميركية في الخارج وتعيدها إلى الولايات المتحدة.	OBJ
من جهة أخرى ، وجدت النمذجة الاقتصادية التي أجراها خبراء من الحزبين الجمهوري والديموقراطي إضافة إلى مستقلين ، أن قانون خفض الضرائب أدى إلى توسيع الاستثمار الرأسمالي في الولايات المتحدة بنسبة 20 في المئة ، في حين وجدت دراسة أجراها فريق من الأكاديميين بقيادة خافيير جارسيا برناردو من جامعة أوتريخت ، أن شركات مثل ألفابت ومايكروسوفت وكوالكوم وميتا ونايكي وسيسكو ، نقلت الملكية الفكرية إلى الولايات المتحدة الأميركية من دول أخرى في أعقاب إقرار هذا القانون.	OBJ
مع اقتراب يوم الانتخابات الرئاسية الأميركية ، تزداد التساؤلات حول مدى قدرة كامالا هاريس على تحقيق رؤية اقتصادية جديدة تعزز من استقرار ونمو الاقتصاد الأميركي في حال فوزها.	OBJ
وفي ظل التحديات التي تواجه الاقتصاد ، مثل التضخم ، وتباطؤ النمو ، وتنامي الدين العام ، تثير خطة هاريس ردود فعل متباينة بين الاقتصاديين والمستثمرين.	OBJ
"ونقلت الصحيفة عن صندوق النقد الدولي أن "" صناع السياسات في الولايات المتحدة وغيرها من الاقتصادات الكبرى نجحوا في كبح جماح أسوأ تضخم في أربعة عقود دون الانزلاق إلى الركود ""."	OBJ
وتضيف الصحيفة : حققت الولايات المتحدة هذا الوضع لأن بنك الاحتياطي الفيدرالي المستقل تمكن من السيطرة على التضخم ؛ ودفع الرئيس جو بايدن بقوانين رئيسية أدت إلى استثمارات ضخمة في البنية التحتية والتكنولوجيا الجديدة ( وحث القطاع الخاص على القيام بنفس الشيء ) ؛ وساهمت سياسات أخرى في تحرير الإنفاق الاستهلاكي ( من بين أمور أخرى ، من خلال توفير مليار دولار للمستهلكين في تكاليف الأدوية وتوفير حافز كبير ).	OBJ
كما يشير إلى تحذيرات وزيرة الخزانة الأميركية جانيت يلين من تفجير التقدم الذي تحقق بالفعل.	SUBJ
"وأشادت يلين بالعلاقة التكافلية بين الحكومة الفيدرالية والقطاع الخاص ، مشيرة إلى أن "" الاستثمارات العامة في مجال الطاقة الخضراء قوبلت بأكثر من خمسة أضعاف الاستثمارات الخاصة ""."	OBJ
""" توضح هذه الصيغة الناجحة لماذا تعد الخطط الاقتصادية لنائبة الرئيس كامالا هاريس ، التي تستند إلى هذا النهج الناجح ، أفضل كثيرا من صيغة دونالد ترامب ( الحمائية ، وتخفيضات الضرائب الضخمة للأثرياء ، وإلغاء قانون خفض التضخم ، وما إلى ذلك )."	OBJ
"ويتفق العديد من خبراء الاقتصاد مع هذا "" ، بحسب التقرير."	SUBJ
"وأضاف : "" على النقيض من ذلك ، فضل 8 بالمئة فقط جعل تخفيضات ترامب الضريبية دائمة ، ولم يؤيد أي خبير اقتصادي خطة التعريفات الجمركية ، ودعم 5 بالمئة فقط إلغاء الضرائب على إعانات الضمان الاجتماعي ""."	OBJ
"وعلى نحو مماثل ، أوضح مجموعة من خبراء الاقتصاد الحائزين على جائزة نوبل "" إن سياسات ترامب ، بما في ذلك التعريفات الجمركية المرتفعة حتى على السلع من أصدقاء وحلفاء أميركا ، والتخفيضات الضريبية التراجعية للشركات والأفراد ، ستؤدي إلى ارتفاع الأسعار ، وعجز أكبر ، وعدم مساواة أكبر ""."	OBJ
"وزعموا أن سياسات هاريس التي تركز على الطبقة المتوسطة "" ستفعل أكثر بكثير من سياسات دونالد ترامب لزيادة القوة الاقتصادية ورفاهية أمتنا وشعبها ""."	SUBJ
"ووفق التقرير ، فإن من بين أهم العوامل التي تحدد النجاح الاقتصادي سيادة القانون واليقين الاقتصادي والسياسي ، وترامب يهدد كل هذا ""."	OBJ
ويوضح تقرير الصحيفة الأميركية في الوقت نفسه أنه من المرجح أن تنتج الاستثمارات التي اقترحتها هاريس ( على سبيل المثال ، في الإسكان ، وفي الشركات الناشئة ، وفي تقنيات القرن الحادي والعشرين ) ، وخطة لتوسيع مدخرات الأدوية الموصوفة والمساعدة الإضافية للمستهلكين ( على سبيل المثال ، ائتمان ضريبة الأطفال ، ائتمان ضريبي آخر للأطفال بقيمة 6000 دولار ) في إحداث نتائج ناجحة.	OBJ
""" وإذا كان الأميركيون يدركون بشكل أفضل النجاح الاقتصادي الأميركي والسياسات التي ساعدت في تحقيقه ، فقد يدركون بشكل أفضل لماذا تحظى خطة هاريس بإشادة كبيرة من جانب خبراء الاقتصاد ، بينما تتعرض خطة ترامب لانتقادات شديدة."	SUBJ
والآن أصبح لدى الناخبين خيار : صيغة هاريس التي ساعدت في تحقيق انتعاش تاريخي ( بناء على قصة النجاح الاقتصادي غير العادية التي حققتها أميركا ) أو صيغة يكاد يكون من المؤكد ، كما يظهر التاريخ ، أنها تنطوي على مخاطر الكارثة الاقتصادية ، بحسب وصف التقرير	SUBJ
في خضم الانتخابات الرئاسية الأميركية ، تتجه أنظار الأسواق نحو المرشحين الرئيسيين ، كامالا هاريس ودونالد ترامب ، لتحديد من يمكن أن يحقق الاستقرار ويعزز النمو الاقتصادي في الولايات المتحدة.	OBJ
بالنسبة للأسواق ، فإن عامل الاستقرار الاقتصادي والاستدامة على المدى البعيد يحتل أولوية ، مما يجعل سياسات هاريس الملتزمة بالطاقة النظيفة والمشاريع المستدامة جاذبة لكثير من الشركات في قطاع التكنولوجيا والطاقة المتجددة.	OBJ
هذا الانقسام يعكس تنوع المصالح في الأسواق ، حيث تتفاوت بين دعم التوسع السريع والمرونة في عهد ترامب ، أو تبني التحول المستدام طويل الأمد مع هاريس.	OBJ
ومع اقتراب موعد الانتخابات ، تتعزز التكهنات حول مدى تأثير كلا المرشحين على البيئة الاستثمارية ، مما قد يجعل السباق الرئاسي محط أنظار كبرى الشركات والمؤسسات المالية التي تتابع عن كثب مستقبل الاقتصاد الأميركي.	OBJ
ويرى مراقبون أن مقترحات ترامب بشأن رفع التعريفات الجمركية على الواردات الصينية قد تؤدي إلى التضخم ، مما قد يضعف أداء الأسهم.	OBJ
أما فيما يخص هاريس : تقترح هاريس رفع ضريبة الشركات إلى 28 بالمئة ، مما قد يضغط على القطاعات المستفيدة من تخفيض الضرائب.	OBJ
"أما فيما يخص "" السندات "" : قد تؤدي سياسات ترامب ، مثل ترحيل المهاجرين وتوسيع الرسوم الجمركية ، إلى رفع أسعار الفائدة كأداة للتحكم في التضخم."	OBJ
وبالتالي ، من المتوقع أن تنخفض أسعار السندات نتيجة لارتفاع العوائد.	SUBJ
أما فيما يخص هاريس ، فمن المرجح أن تخفض إدارة هاريس معدلات الفائدة ، بفضل سياسات أقل تضخمية مما يتيح للاحتياطي الفيدرالي خفض أسعار الفائدة.	OBJ
"يتوقع "" غاتام شغاني "" المحلل لدى "" برنشتاين "" أن تصل أسعار البيتكوين إلى 90 دولار إذا فاز ترامب."	OBJ
لكن على العموم ، يرى الخبراء أن التزايد المستمر في الديون الحكومية الأميركية سيدعم البيتكوين بغض النظر عن الرئيس.	SUBJ
فيما يخص ترامب ، تتمثل الإيجابيات من وجهة نظر السوق ، بحسب الإدريسي ، فيما يلي : خفض الضرائب والتخفيف من القيود التنظيمية ، ذلك أنه خلال فترة رئاسته السابقة ، اعتمد ترامب سياسات تهدف إلى خفض الضرائب على الشركات والأفراد ، إضافة إلى تقليل القيود التنظيمية على قطاع الأعمال.	OBJ
أما السلبيات من وجهة نظر الأسواق : السياسات الحمائية والنزاعات التجارية.	OBJ
حربه التجارية مع الصين وغيرها من الدول تسببت في تقلبات كبيرة في الأسواق وعدم يقين بشأن سلاسل التوريد العالمية.	SUBJ
سياسته المتعلقة بخفض الضرائب وزيادة الإنفاق العسكري أدت إلى زيادة العجز في الميزانية ، ما قد يرفع تكاليف الاقتراض ويؤثر على استقرار الأسواق على المدى الطويل.	OBJ
أما السلبيات من وجهة نظر الأسواق : زيادة الضرائب على الشركات والأثرياء ، فإذا تبنت هاريس سياسات لزيادة الضرائب بهدف تمويل البرامج الاجتماعية أو الاستثمارات في البنية التحتية ، فقد يؤدي ذلك إلى قلق الأسواق بشأن انخفاض أرباح الشركات.	OBJ
التوجه نحو التنظيم الصارم : هاريس قد تتبنى سياسات تنظيمية أكثر صرامة في قطاعات مثل التكنولوجيا والطاقة ، ما قد يثير قلق بعض المستثمرين بشأن التأثير على أرباح الشركات.	OBJ
ومع ذلك ، القلق من النزاعات التجارية والحمائية يمكن أن يسبب تقلبات كبيرة.	SUBJ
لكن الفروقات تظهر في بعض القطاعات وأنواع الصناعات.	SUBJ
بالنسبة للشركات الكبرى ، فإن فوز ترامب وإصراره على تخفيض معدلات الضرائب على الشركات ، مع قدرته على تمويل هذه التخفيضات ، قد يكون له أثر إيجابي عليها ، من حيث زيادة الأرباح واستخدام جزء من هذه الأرباح في التطوير والابتكار.	OBJ
ويؤمن الكثيرون بأن السياسات الضريبية لترامب ستكون داعمة للأسواق بشكل عام.	SUBJ
وستؤدي هذه السياسات إلى ارتفاع في المستوى العام للأسعار داخل الولايات المتحدة ، مما قد يدفع الاحتياطي الفيدرالي إلى رفع أسعار الفائدة لمواجهة التضخم.	OBJ
سيؤدي ذلك إلى ارتفاع قيمة الدولار مقابل العملات الأخرى ، مما يجعل البضائع الأميركية أكثر تكلفة ويقلص من صادراتها ، وهو ما قد يضع الاقتصاد في حالة ركود.	OBJ
فيما يلفت إلى أن سياسات هاريس تختلف عن سياسات ترامب ، حيث تنوي رفع معدل الضرائب على الشركات من 21 بالمئة إلى 28 بالمئة.	OBJ
"وظهرت تحذيرات من "" هجرة محتملة "" بعد أسابيع من التكهنات بشأن خطط راشيل ، والتي من المتوقع على نطاق واسع أن تشمل زيادة الضرائب وسلسلة من تخفيضات الإنفاق."	OBJ
"وفي تحذير أخير قبل إعلان الميزانية يوم الأربعاء المقبل ، قالت مجموعة الضغط "" تحالف الشركات الناشئة "" إن ثقة المؤسسين في بريطانيا سوف "" تهتز "" بشكل أكبر إذا استهدفت ريفز رواد الأعمال بزيادة ضريبة مكاسب رأس المال."	OBJ
يمثل المؤسسون شركات توظف أكثر من 22 ألف شخص ، ويبلغ مجموع إيراداتها 2.	OBJ
تكتسب هذه الضريبة أهمية خاصة بالنسبة لرجال الأعمال ؛ لأنها تصبح واجبة الدفع بمجرد بيع أعمالهم أو أسهمهم.	SUBJ
"في الأسبوع الماضي ، حاول رئيس الوزراء البريطاني ، كير ستارمر ، استبعاد المخاوف من إمكانية رحيل رجال الأعمال عن المملكة المتحدة ، بحجة أنه "" لا يوجد سبب "" يدفعهم إلى ذلك."	OBJ
"وقال فيليب سالتر ، مؤسس المجموعة ، الأسبوع الماضي إن القضية بالنسبة لعديد من رواد الأعمال "" أكبر من خروج بريطانيا من الاتحاد الأوروبي ""."	SUBJ
وقد أثارت هذه الخطط قلق الشركات ، مما أدى إلى استعداد عدد من الشركات الكبرى لمغادرة السوق البريطانية.	SUBJ
كما أن تقليص الإنفاق الحكومي قد يؤدي إلى تراجع الطلب على المنتجات والخدمات ، مما يزيد من الضغوط على هذه الشركات.	SUBJ
واختتم تصريحاته بقوله : إن الخطط الحكومية الرامية لزيادة الضرائب وخفض الإنفاق هي خطوة جريئة في سياق التحديات الاقتصادية لكنها تحتاج إلى إيجاد حالة من التوازن الدقيق بين الأهداف المالية والاحتفاظ بجاذبية المملكة المتحدة كمركز تجاري.	OBJ
40 مليار جنيه إسترليني وكجزء من الخطط التي ستكشف عنها في الثلاثين من أكتوبر ، تسعى ريفز إلى جمع نحو 40 مليار جنيه إسترليني ( 52 مليار دولار ) للمساعدة في تمويل أولويات حزب العمال وسد الفراغ المالي الذي تلقي باللوم فيه على سلفها المحافظ ، وقد أثار ذلك مخاوف بشأن رفع مجموعة من الضرائب وخروج الأثرياء من بريطانيا.	OBJ
أخبار ذات صلة اقتصاد نمو اقتصادي في بريطانيا يعزز موقف الحكومة العمالية خاص كيف تؤثر أزمات الشرق الأوسط على الاقتصاد البريطاني ؟	OBJ
وكشفت بلومبرغ الأسبوع الماضي أن أحد التدابير قيد الدراسة هو خفض الإعفاء الضريبي على مكاسب رأس المال لأولئك الذين يبيعون أعمالهم ، والمعروف باسم الإعفاء من التخلص من أصول الأعمال.	OBJ
إذ تقول المستشارة إن المحافظين تركوا لها فجوة قدرها 22 مليار جنيه إسترليني في ميزانية هذا العام تحتاج إلى سدها من أجل إصلاح أسس الاقتصاد.	SUBJ
هزة للاقتصاد البريطاني من جانبه ، أكد الخبير الاقتصادي الدكتور أنور القاسم أنه : بحكم التجارب السلبية السابقة فزيادة الضرائب التي تحملها الميزانية الجديدة قد تهز الاقتصاد البريطاني وتضعف عجلة الإنتاج وتتسبب في هروب بعض رؤوس الأموال والاستثمارات.	OBJ
من المتوقع أن تفقد البلاد حوالي 10 آلاف ثري ، بسبب نية السلطات زيادة الضرائب على رأس المال الكبير ، وتعزيز الرقابة المالية.	OBJ
""" الجميع الآن بانتظار تفاصيل الميزانية الجديدة ، التي مهدت الحكومة لها كي لا تؤدي إلى هزة في سوق المال والأعمال وقد يبعث رسالة سلبية للمستثمرين ورجال الأعمال ""."	OBJ
وذكر أنه في هذا المخاض الضريبي يبدو أن أعين الكثير من المستثمرين تتجه الى إسبانيا وإيطاليا وسويسرا ودبي وسنغافورة والتي تثبت شعبيتها للمستثمرين الذين يبحثون عن مكان منخفض الضرائب للعيش فيه.	SUBJ
أظهر استطلاع جديد للرأي أجرته صحيفة فاينانشال تايمز البريطانية ، أن دونالد ترامب تفوق على كامالا هاريس باعتباره المرشح الذي يحظى بثقة الأميركيين فيما يتعلق بالاقتصاد ، وهو ما يسلط الضوء على كفاح الحزب الديمقراطي لإقناع الناخبين بأنهم في حال أفضل الآن مما كانوا عليه قبل أربع سنوات.	OBJ
أظهر الاستطلاع الشهري النهائي الذي أجرته الصحيفة بالتعاون مع كلية روس لإدارة الأعمال بجامعة ميشيغان أن 44 بالمئة من الناخبين المسجلين قالوا إنهم يثقون في قدرة ترامب على التعامل مع الاقتصاد أكثر مقابل 43 بالمئة لهاريس.	OBJ
بحسب تقرير للصحيفة ، تمثل هذه النتائج ، التي تأتي قبل أقل من أسبوعين من الانتخابات ، المرة الأولى التي يتفوق فيها ترامب على هاريس بشأن هذه القضية في استطلاع الرأي الذي أجرته صحيفة فاينانشال تايمز ومؤسسة ميشيغان روس.	OBJ
كما أظهر الاستطلاع أن ترامب يتمتع بفارق أكبر بين الناخبين بشأن السؤال حول أي مرشح من شأنه أن يجعلهم في وضع أفضل ماليا.	SUBJ
تشير النتائج إلى أن خطاب هاريس الاقتصادي قد نفد زخمه في المرحلة الأخيرة من السباق المتقارب بشكل متزايد مع ترامب.	SUBJ
ويظهر متتبع استطلاعات الرأي لصحيفة فاينانشال تايمز الآن أن المرشحين في حالة تعادل شبه تام في الولايات المتأرجحة التي ستقرر نتيجة الانتخابات.	OBJ
""" إذا كانت ستفوز في الانتخابات ، فسوف يتعين عليها أن تفوز بها على أساس قضايا أخرى ""."	SUBJ
وفق الصحيفة ، فقد كان رفض الناخبين منح هاريس ورئيسها الرئيس جو بايدن الفضل في النمو الاقتصادي القوي وانخفاض معدلات البطالة سمة مستمرة في استطلاع FT - Michigan Ross منذ الاستطلاع الأول في نوفمبر 2023.	OBJ
تفوقت هاريس على ترامب لفترة وجيزة في ما يتصل بالاقتصاد بعد أن حلت محل بايدن في بطاقة الحزب الديمقراطي هذا الصيف ، لكن هذه الميزة تم محوها.	SUBJ
ومع بقاء أقل من أسبوعين حتى يوم الانتخابات في الخامس من نوفمبر ، يسلط الاستطلاع الضوء على العقبة الكبرى التي تواجه هاريس.	SUBJ
"فقد وجد الاستطلاع باستمرار أن الناخبين يصنفون "" القضايا الاقتصادية ، مثل الوظائف وتكاليف المعيشة "" باعتبارها "" القضية الأكثر أهمية "" في تحديد أصواتهم للرئيس."	OBJ
ورغم أن هاريس حققت نتائج أفضل في استطلاعات الرأي بشأن القضايا الاقتصادية مقارنة ببايدن عندما كان مرشحا ديمقراطيا ، فقد واجه الحزب صعوبة في إقناع الناخبين بأنهم قادرون على إدارة الاقتصاد.	SUBJ
"وعندما سئلوا عما إذا كانوا أفضل حالا ماليا في ظل رئاسة ترامب أو بايدن ، قال 51 في المائة إنهم كانوا "" أفضل كثيرا "" أو "" إلى حد ما "" في ظل رئاسة الجمهوريين."	OBJ
وقال 28 في المائة فقط إنهم كانوا أفضل حالا في ظل رئاسة بايدن.	SUBJ
ولا يزال الناخبون يتحسرون على ارتفاع تكاليف المعيشة بسبب ارتفاع التضخم في عام 2022 ، والذي ترك الأسعار مرتفعة ويستمر في التأثير بشكل كبير على معنويات المستهلكين.	SUBJ
وأشار أكثر من ثلاثة أرباع الناخبين إلى أن زيادات الأسعار تعد واحدة من أكبر مصادر الضغوط المالية التي يواجهونها ، وهو رقم ظل ثابتا على نطاق واسع خلال الاثني عشر شهرا منذ إطلاق الاستطلاع.	OBJ
سياسات هاريس وترامب وأصر ترامب على أنه سيعمل على خفض تكاليف المعيشة من خلال خفض أسعار الطاقة والضرائب مثل تلك المفروضة على الإكراميات والعمل الإضافي للعاملين بالساعة والمزايا للمواطنين كبار السن.	OBJ
وأشار الاستطلاع المشار إليه إلى أن بعض رسائل هاريس في هذا الصدد تلقى صدى ، حيث قال 49 بالمئة من الناخبين إنها تمثل مصالح الطبقة المتوسطة بشكل أفضل ، بينما قال 37 بالمئة إن ترامب يمثلهم بشكل أفضل.	SUBJ
كما يعتقد الناخبون أن نائب الرئيس يمثل مصالح الشركات الصغيرة والعمال ذوي الياقات الزرقاء وأعضاء النقابات بشكل أفضل.	SUBJ
لكن الجمهوري جعل أيضا من الحماية الجمركية محورا أساسيا في خطابه الاقتصادي ، حيث تعهد بفرض رسوم جمركية باهظة على كل شيء بدءا من السيارات إلى المنتجات الاستهلاكية المصنعة في الخارج.	OBJ
"وأظهر الاستطلاع أنه في حين وافقت أغلبية الناخبين على ضرورة زيادة الرسوم الجمركية على السلع القادمة من الصين إما "" بشكل كبير "" أو "" إلى حد ما "" ، فإن النسبة الأكبر من الناخبين عارضت زيادة الرسوم الجمركية على الواردات من دول أخرى."	OBJ
"العوامل الاقتصادية بدوره ، أفاد رئيس قسم الأسواق العالمية في Cedra Markets ، جو يرق ، في تصريحات خاصة لموقع "" اقتصاد سكاي نيوز عربية "" ، بأن : ترامب يتقدم بشكل كبير في استطلاعات الرأي على كامالا هاريس ، وذلك يعود بشكل رئيسي إلى سياساته الاقتصادية."	OBJ
ويضيف : ترامب ، كرجل أعمال محب للأسواق ، يدعم بشكل عام قطاعات اقتصادية مختلفة مثل شركات النفط والبنوك.	SUBJ
حتى مع فرض التعريفات الجمركية ، نراه يدعم الشركات الأميركية ، بما في ذلك قطاع الكهرباء.	OBJ
كما أن سياساته تؤكد على تخفيض الفوائد والإنفاق الحكومي الكبير ، الذي يعزز الحركة الاقتصادية ويقوي الاقتصاد ، رغم أنه قد يؤدي إلى زيادة التضخم ، وهو ما يحاول الاحتياطي الفيدرالي الأميركي مواجهته.	OBJ
ولا ننسى أن ترامب ، من خلال سياساته الاقتصادية ، يدعم الشركات بشكل مباشر عبر تخفيض الضرائب على الأرباح ، حيث قام بتخفيضها بالفعل من 35 إلى 21 بالمئة ، وهناك توجه لتخفيضها إلى 15 بالمئة.	OBJ
"تباين الاستطلاعات ورغم نتائج استطلاع "" فاينانشال تايمز "" تشير استطلاعات رأي أخرى إلى أن دونالد ترامب فقد ميزته على كامالا هاريس فيما يتعلق بمن هو الأفضل تأهيلا لإدارة الاقتصاد."	OBJ
"أخبار ذات صلة خاص "" الاقتصاد ""."	SUBJ
ورقة الحسم بين ترامب وهاريس ؟	SUBJ
أخبار روسيا الكرملين يعلق على مناظرة ترامب وهاريس.	SUBJ
"ما حدث "" غير مقبول "" وبحسب الصحيفة ، تعزز هذه النتيجة اتجاها من نفس الاستطلاع الشهر الماضي ، والذي أظهر أن هاريس نجحت تقريبا في سد العجز الكبير السابق مع ترامب ، الرئيس الأميركي السابق والمرشح الجمهوري ، حول من يمكنه التعامل بشكل أفضل مع القضايا الاقتصادية."	OBJ
كما تتمتع نائبة الرئيس الأميركي بميزة طفيفة فيما يتعلق بتكلفة الإسكان ، بينما ينقسم الناخبون بالتساوي حول أي منهما لديه سياسات أفضل بشأن أسعار البقالة والبنزين ، وخلق فرص العمل أو معالجة البطالة.	OBJ
والتوقعات أكثر إيجابية مقارنة بأكتوبرمن العام الماضي ، عندما قال ما يقرب من ثلاثة من كل أربعة أشخاص أن الاقتصاد في حالة سيئة.	SUBJ
ولطالما سعت حملة ترامب إلى جعل التضخم وارتفاع تكاليف المعيشة نقطة محورية لانتقادها لرئاسة جو بايدن.	SUBJ
ومثال على ذلك السياسات الحمائية التي ينوي اتباعها في فرض الرسوم الجمركية على جميع المنتجات المستوردة من الخارج ، وخاصة من الصين ، إذ ينوي فرض رسوم تصل إلى 60 بالمئة.	OBJ
هذا الفرق في السعر بين المنتجات الأجنبية والمحلية سيسمح للشركات الأميركية برفع أسعارها ، وبالتالي لن يكون هناك مفر من ارتفاع معدلات التضخم.	SUBJ
هل يصمد الاقتصاد الإيراني أمام هجمات إسرائيلية وشيكة ؟	SUBJ
وتستعد إسرائيل للرد على الهجوم الإيراني بعشرات الصواريخ الباليستية هذا الشهر ، والذي قالت طهران إنه جاء ردا على مقتل حسن نصر الله ، زعيم حزب الله المدعوم من إيران ، وقائد كبير في الحرس الثوري الإيراني في غارات جوية على بيروت.	OBJ
وأبلغ كبار المسؤولين الإسرائيليين الولايات المتحدة أنهم يخططون لاستهداف مواقع عسكرية.	SUBJ
"كما أدى توقع وقوع هجوم إسرائيلي إلى فوضى في حركة السفر ، حيث ألغت شركات الطيران رحلاتها ، مما أدى إلى ارتفاع أسعار التذاكر وإطالة أوقات السفر نتيجة لإعادة توجيه الرحلات ، بحسب تقرير لصحيفة "" فايننشال تايمز "" البريطانية ، والذي أشار إلى أن : العديد من الإيرانيين يشعرون الآن بقلق عميق إزاء احتمال اندلاع حرب محتملة بين إيران وإسرائيل ، التي تعهدت برد "" دقيق وقاتل "" بعد تصعيد الأعمال العدائية منذ تبادل سابق لإطلاق النار في أبريل."	OBJ
في حين يصر الموالون للنظام على أن إيران لا تخشى الحرب وترحب بالمواجهة العسكرية مع إسرائيل ، يخشى كثيرون من أن اقتصاد البلاد المتضرر من العقوبات لا يستطيع تحمل دورة أخرى من التصعيد.	SUBJ
"وفي الأسبوع الماضي ، ألغت شركة الطيران الإيرانية الرائدة "" إيران إير "" رحلاتها إلى وجهات أوروبية بعد أن فرض الاتحاد الأوروبي عقوبات على شركة الطيران بسبب ما قالت إنه نقل صواريخ باليستية إلى روسيا لاستخدامها ضد أوكرانيا ، وهو ما تنفيه إيران."	OBJ
"وفي سياق متصل ، نقلت الصحيفة عن محلل الاقتصاد السياسي سعيد ليلاز ، قوله : "" إن الحكومة كانت تدير العرض والطلب في سوق العملة للحد من التقلبات الكبيرة ""."	OBJ
""" من المؤكد أن هناك أجواء نفسية تؤثر على البلاد ، لكن هذه الاضطرابات الجديدة لن تثني إيران عن مواصلة سياساتها الإقليمية أو الرد على أي هجو تداعيات صعبة في تصريحات خاصة لموقع "" اقتصاد سكاي نيوز عربية "" ، يقول المدير التنفيذي للمركز العربي للبحوث والدراسات ، هاني سليمان : سيكون هناك تأثير صعب وقوي للهجوم الإسرائيلي الوشيك على طهران ، على الاقتصاد الإيراني."	OBJ
الأسئلة المثارة الآن في هذا السياق : هل ستكون الهجمات على المنشآت النووية الإيرانية أو المؤسسات المرتبطة بها ، أم ستكون على منشأة عسكرية تقليدية مرتبطة بالحرس الثوري والنظام ؟	OBJ
قلاوون : الاقتصاد الإيراني لن يتمكن من تحمل حرب مع إسرائيل عدم يقين ويشير تقرير للمجلس الأطلسي ، إلى أنه لا تزال حالة عدم اليقين تخيم على إيران مع تعهد المسؤولين الإسرائيليين بالرد على الهجوم الصاروخي الباليستي الذي شنته طهران على إسرائيل في وقت سابق من هذا الشهر.	OBJ
ومع ذلك ، في حين تركز معظم التحليلات على الأهداف الجيوسياسية لإيران في المنطقة ، كان هناك قدر أقل من النقاش حول القيود الاقتصادية الشديدة التي يواجهها النظام الإيراني.	SUBJ
ويشير المجلس إلى أن : الاقتصاد الإيراني ضعيف الأداء - ومن بين زملائها من أعضاء مجموعة البريكس ، فإن إيران لديها أحد أضعف الاقتصادات.	OBJ
تحوم معدلات التضخم حول 34 بالمئة.	SUBJ
منذ العقوبات الاقتصادية الأميركية الأولية ، ظل نمو الناتج المحلي الإجمالي الإيراني أقل باستمرار من أعلى مستوياته في العام 2011.	SUBJ
تشير توقعات صندوق النقد الدولي إلى أن الناتج المحلي الإجمالي للبلاد سيستمر في التخلف عن تلك الذروة حتى العام 2029.	SUBJ
مصانع الغاز والطاقة الإيرانية صدئة وعفا عليها الزمن ، وتعمل بنسبة 70 بالمئة فقط من طاقتها.	SUBJ
وعدم قدرة البلاد على التحديث هو نتيجة مباشرة لانسحاب الشركات الغربية من البلاد على مدى العقد الماضي.	SUBJ
وهذا بالإضافة إلى المخاوف المستمرة من الفساد وسوء الإدارة.	SUBJ
هل يصمد الاقتصاد الإيراني أمام حرب مع إسرائيل ؟	SUBJ
ترتفع معدلات الفقر والبطالة بشكل ملحوظ.	SUBJ
هذه الإجراءات زادت من معاناة الشعب الإيراني ، خاصة في ظل تراجع الإيرادات.	SUBJ
ويشير سليمان إلى أن استمرار المواجهات مع إسرائيل وتوسيع الصراع وفتح جبهات جديدة سيؤدي إلى زيادة معاناة الشعب الإيراني ، وقد يتسبب في تراجع العملة أكثر في ظل الأوضاع المتوترة.	SUBJ
إن قيام إسرائيل بهجمات تستهدف قطاعات حيوية في البلاد ، مثل منشآت الطاقة وغيرها ، سوف يعمق بشكل كبير الحالة الاقتصادية المتردية.	OBJ
ويلفت إلى أن كل هذه المخاطر قد تؤدي إلى إثارة الشارع السياسي الإيراني الداخلي ، وربما ينتج عنها اندلاع احتجاجات واسعة النطاق في المحافظات الإيرانية (.	OBJ
ويقول إن إيران التي واجهت انتفاضة شعبية كبرى في نوفمبر 2019 بعد رفع أسعار الوقود ، تخشى اليوم من هجمات إسرائيلية قد تضرب منشآتها النفطية ، وهو ما سيكون له تداعيات بالغة الأهمية على الأوضاع المعيشية داخل إيران ، خاصة مع اقتراب فصل الشتاء وحاجة إيران المتزايدة للتدفئة.	OBJ
يمكن العودة إلى حادثة إسقاط الطائرة الأوكرانية في أعقاب الرد الإيراني على اغتيال الجنرال قاسم سليماني في يناير 2020 ، وهو ما تخشى إيران تكراره اليوم نتيجة الترقب لهجوم إسرائيلي واسع داخل البلاد.	OBJ
لذلك ، تفرض إيران محاذير وإجراءات على حركة الطيران الداخل	SUBJ
فإن عدم وجود مدخرات كافية يمكن أن يؤدي إلى ضغوط مالية أثناء الطوارئ وصعوبة تحقيق الأهداف المالية طويلة الأجل.	SUBJ
ووفق المؤسسة ، فإن عدم وجود أموال كافية في المدخرات قد يؤدي إلى زيادة التوتر أثناء حالات الطوارئ ، والاعتماد على بطاقات الائتمان لدفع الفواتير غير المتوقعة وصعوبة تحقيق الأهداف المالية طويلة الأجل مثل امتلاك منزل أو التقاعد.	OBJ
ويوصي معظم الخبراء الماليين بتوفير ما لا يقل عن ثلاثة أشهر من النفقات لمواجهة النكسة المالية مثل فقدان الوظيفة أو الديون الطبية الكبرى.	OBJ
وقد جمعت المؤسسة أفضل 14 نصيحة لتوفير المال لمساعدة الأشخاص على إنفاق أقل وتنمية حساباتهم المصرفية ، وهي : مراجعة عادات الإنفاق : ابدأ بتحديد كيف تصرف أموالك من خلال مراجعة بياناتك البنكية.	SUBJ
يمكنك تحديد مجالات تقليل التكاليف.	SUBJ
أتمتة مدخراتك : قم بإعداد تحويلات تلقائية من حسابك الجاري إلى حساب التوفير ، مما يساعدك على بناء مدخراتك دون جهد إضافي.	SUBJ
استخدام تطبيقات المكافآت النقدية للحصول على استرداد نقدي على المشتريات.	SUBJ
إعادة النظر في مزود الهاتف المحمول من خلال التحقق من خطتك الهاتفية.	SUBJ
قد تجد خيارات أرخص من شركات منافسة.	SUBJ
إيقاف الإشعارات المغرية : قم بإيقاف الإشعارات والعروض الترويجية على هاتفك لتجنب الإغراءات الشرائية.	SUBJ
تقليل فواتير المرافق : اتخذ خطوات بسيطة مثل استخدام مصابيح LED وإصلاح التسريبات لتقليل تكاليف الكهرباء والماء.	SUBJ
استغلال المعالم المحلية المجانية : ابحث عن أنشطة مجانية في منطقتك مثل المتاحف التي تقدم أيام دخول مجانية.	SUBJ
تسوق بحكمة للبقالة : قم بإعداد قائمة تسوق لتقليل هدر الطعام والتأكد من عدم شراء ما لا تحتاجه.	SUBJ
ابحث عن بدائل اقتصادية للمنتجات ذات العلامات التجارية ، حيث قد تكون غير مكلفة بنفس الجودة.	SUBJ
استكشاف خيارات مصرفية أخرى : تحقق من حسابات مصرفية بدون رسوم شهرية ، مثل تلك المقدمة من البنوك الإلكترونية.	SUBJ
يمكنك خفض أقساط التأمين عن طريق البحث عن خيارات جديدة.	SUBJ
استخدام القسائم والرموز الترويجية : ابحث عن رموز القسائم عند التسوق عبر الإنترنت لتوفير المزيد من المال.	SUBJ
تحدي نفسك لعدم الإنفاق : قم بتجربة فترة من عدم الإنفاق على غير الضروريات ، وستلاحظ كم يمكنك توفيره.	SUBJ
"الموارد والاحتياجات من جانبه ، قال أستاذ الاقتصاد والمالية العامة بكلية الدراسات القانونية والمعاملات الدولية في جامعة فاروس ، الدكتور أحمد العجمي ، لموقع "" اقتصاد سكاي نيوز عربية "" إن مبدأ التوفير يعد من الأمور المهمة في حياة الأفراد."	OBJ
كما أوضح أن من أهم النصائح المتعلقة بالتوفير إدارة الاستهلاك بحكمة ووضع قائمة بالأولويات ، مع تحديد حد أقصى للإنفاق ، مما يسهم في تعزيز القدرة على توفير المال.	OBJ
وشدد على ضرورة تخصيص نسبة من الدخل للإدخار في شكل أصول مثل الذهب أو الأوعية الإدخارية بالبنوك ؛ بهدف حماية الأفراد من التقلبات الاقتصادية المستقبلية.	OBJ
واختتم العجمي حديثه بالتأكيد على أهمية التخطيط المالي والوعي بأهمية الإدخار من أجل مواكبة التطورات الاقتصادية وتحقيق استقرار مالي مستدام أهم الأدوات بدوره ، قال الباحث الاقتصادي ياسين أحمد ، إن توفير المال يعد من أهم الاستراتيجيات التي تساعد الأفراد على مواجهة التحديات والتقلبات الاقتصادية المستمرة.	OBJ
"وفي تصريحاته الخاصة لموقع "" اقتصاد سكاي نيوز عربية "" ، أكد على أن هناك عدة خطوات يمكن للأفراد اتباعها لتحقيق التوفير بشكل فعال."	SUBJ
وأضاف أن وضع ميزانية شهرية تشمل الإيرادات والنفقات ، مع تحديد الأولويات بين الضروريات والترفيهيات ، يسهم بشكل كبير في تحديد وجهات الإنفاق بوضوح.	OBJ
كما أوصى بالاستفادة من العروض والخصومات عند شراء المستلزمات الأساسية ، مما يساعد في تحسين القدرة الشرائية وتحقيق وفورات مالية.	SUBJ
كما أكد ضرورة الاستثمار في الأمور الضرورية وتجنب القرارات العاطفية في الشراء ، بما يضمن تحقيق التوازن المالي والحفاظ على السيولة النقدية لمواجهة التحديات المستقبلية.	OBJ
"وبحسب تقرير أعدته "" بلومبرغ "" واطلع عليه موقع "" اقتصاد سكاي نيوز عربية "" ، فقد أثبتت صناعة "" المشاهير الموتى "" أنها صناعة مربحة ، في عالم تسيطر عليه تقنيات الذكاء الاصطناعي المتطورة ، فعادة عندما يموت أحد المشاهير ، تتوقف عائدات خدماته الشخصية على الفور ، ولا يتبقى لورثته سوى عائدات الملكية الفكرية ، ولكن الآن ساعد الذكاء الاصطناعي على إعادة المشاهير الموتى إلى العمل مرة أخرى ، وجعلهم يكسبون الملايين من الدولارات."	OBJ
ويقول ترافيس كلويد ، مؤسس ورئيس مجلس إدارة شركة Worldwide XR إن عملية إنشاء ممثل رقمي لجيمس دين ، تبدأ من قاعدة المواد المصدرية ، أو ما يسمى بالأصول الموروثة للفنان ، التي تشمل مختلف مقاطع الفيديو العائدة له ، وحتى الفيديوهات العائلية الخاصة ، حيث يتم تمرير هذه المقاطع لبرامج التعلم الآلي ، العاملة بالذكاء الاصطناعي ، التي تقوم بإنشاء نموذج رقمي للممثل.	OBJ
وأشار إلى أن الإمكانات المتاحة لمشاريع الذكاء الاصطناعي في عالم الترفيه ، ستصبح المحرك الرئيسي للدخل في السنوات الخمس المقبلة ، حيث ستكون هناك فرص وفيرة للمشاهير ، لتحقيق الدخل من إرثهم بطرق جديدة ومثيرة.	OBJ
وربما يأتي أكبر اختبار للذكاء الاصطناعي في عالم الترفيه في الربيع المقبل ، عندما ستعيد شركة Layered Reality ملك الروك آند رول إلفيس بريسلي إلى خشبة المسرح ، من خلال عرض يحمل اسم Elvis Evolution.	OBJ
فبحسب أندرو ماكغينيس ، مؤسس Layered Reality ، لم تكن إعادة بريسلي إلى المسرح في شكل صورة ثلاثية الأبعاد بالمهمة السهلة ، حيث استغرق الأمر مئات الساعات من الأداء ، ومقاطع الفيديو المنزلية لبريسلي ، التي تم إدخالها في برنامج الذكاء الاصطناعي لإنشاء نسخة رقمية له.	OBJ
"بدورها قامت شركة ElevenLabs الناشئة ، لاستنساخ الأصوات بالذكاء الاصطناعي ، وكجزء من مشروع "" الأصوات الأيقونية "" التابع لها ، بالحصول على موافقة ورثة المغنية والممثلة جودي جارلاند والممثل لورانس أوليفييه والممثل بيرت رينولدز ، لاستخدام أصوات هؤلاء في قراءة الكتب والمقالات والمواد النصية الموجودة في تطبيق Reader."	OBJ
وكشف أن شركته CMG Worldwide Inc أبرمت حوالي 30 ألف صفقة بشأن حقوق الملكية الفكرية ، نيابة عن أكثر من 3000 من المشاهير ، معظمهم ميت.	OBJ
"رأي معارض ورغم الإقبال الكبير الذي تشهده صناعة "" المشاهير الموتى "" ، إلا أن هناك من هو غير مقتنع بهذا الموضوع."	SUBJ
ويشرح القارح أنه يمكن لبرامج وأدوات الذكاء الاصطناعي التوليدي ، إعادة المشاهير الموتى إلى العمل مرة أخرى ، من خلال عدة طرق.	SUBJ
كما أن تقنيات توليد الصوت عبر الذكاء الاصطناعي تتيح إمكانية إعادة إنتاج أصوات المشاهير الموتى بشكل دقيق ، مما يجعل أداءهم بالأعمال الجديدة يبدو وكأنه صادر عنهم بالفعل.	SUBJ
وبعد تحليل هذه المعلومات واستخراج الأنماط اللغوية والعاطفية والسلوكية ، يقوم الذكاء الاصطناعي بتوليد محتوى جديد يتماشى مع أسلوبهم الفريد ، وعلى سبيل المثال ، يمكن للذكاء الاصطناعي أن يتعلم كيفية استخدام المشاهير الموتى للغة ، وأنماط النكتة أو حتى انفعالاتهم العاطفية ، مما يعزز من مصداقية الأعمال الجديدة التي ينتجها لهم.	OBJ
وتعتبر جلاد أن التحدي الأكبر في موضوع عودة المشاهير الموتى للعمل ، هو ضمان احترام حقوقهم وميراثهم الفني ، ومنع استغلال تقنيات الذكاء الاصطناعي لهذا الأمر.	SUBJ
"في أغسطس الماضي ، طرح ترامب فكرة أنه - كرجل أعمال ناجح - يجب أن يكون لديه "" على الأقل "" رأي في السياسة النقدية للاحتياطي الفيدرالي."	SUBJ
"ووجدت دراسة جديدة من معهد بيترسون للاقتصاد الدولي ، وهو مركز فكري غير حزبي معروف ، أن مثل هذه الفكرة قد تكون لها "" عواقب اقتصادية كارثية ""."	SUBJ
قام الباحثون الرئيسيون في الدراسة بتحليل الأثر الاقتصادي لثلاثة من وعود ترامب الانتخابية : الترحيلات الجماعية ، والرسوم الجمركية ، وتقويض استقلال الاحتياطي الفيدرالي.	OBJ
خلال فترة رئاسية محتملة لترامب ، وجدت الدراسة أن تقويض استقلال الفيدرالي سيؤدي إلى خسائر اقتصادية تبلغ 304 مليارات دولار.	OBJ
ووجدوا أن مثل هذا الإجراء سيؤدي إلى انخفاض الناتج المحلي الإجمالي وارتفاع التضخم حتى عام 2040.	SUBJ
"وبحسب ما نقله موقع "" بيزنس إنسايدر "" عن أحد مؤلفي الدراسة ، واريك ماكيبين ، وهو زميل كبير في معهد بيترسون ، فإن : الناتج المحلي الإجمالي والعمالة سيرتفعان في البداية ، لكن التضخم وتكاليف المدخلات سترتفع بسرعة بعد ذلك."	OBJ
في النهاية ، سيتدفق رأس المال خارج الولايات المتحدة ، مما يتسبب في انخفاض قيمة الدولار.	SUBJ
ومع ارتفاع أسعار السلع المحلية ، ستنخفض القوة الشرائية للعمال.	SUBJ
ووجدت الدراسة أن الإنتاج سيتحول إلى أجزاء أخرى من العالم ، بما في ذلك الصين.	SUBJ
وبحسب الدراسة ، فإن الاقتصاد سيصل إلى أدنى مستوياته في عام 2028 ، ثم يبدأ في التعافي.	SUBJ
خطط غامضة وفي حين تظل أفكار ترامب المحددة بشأن بنك الاحتياطي الفيدرالي غامضة ، فإن بعض حلفائه يقومون بهدوء بصياغة خطط حول كيفية تجريد البنك المركزي من الاستقلال ، حسبما ذكرت صحيفة وول ستريت جورنال.	OBJ
ورأوا أن هاريس لا تعتقد بأن الجمهور يولي اهتماما كافيا لمخاطر مقترحات ترامب لمجلس الاحتياطي الفيدرالي أو الغموض العام الذي يكتنف السياسة الاقتصادية للمرشحين ، ولم يشارك ترامب ولا هاريس الكثير حول كيفية تنفيذ مقترحاتهما أو تأثيراتها الاقتصادية الطويلة الأجل.	OBJ
علاقة ترامب والفيدرالي رئيس الأسواق العالمية في Cedra Markets ، جو يرق ، استبعد إمكانية نجاح ترامب في السيطرة على الفيدرالي الأميركي.	OBJ
"وأكد في حديثه مع موقع "" اقتصاد سكاي نيوز عربية "" أن الفيدرالي هيئة مستقلة تدير السياسة النقدية للولايات المتحدة ، بينما تركز الحكومة على الجانب المالي."	OBJ
وأضاف يرق أنه في حال وصول ترامب إلى البيت الأبيض ، فإنه سيحتاج إلى إصدار تشريع جديد لإعادة سن القوانين المتعلقة	SUBJ
جعلت الضربات التي وجهتها إسرائيل إلى هرم القيادة في حزب الله ، الأمين العام حسن نصر الله في موقف لا يحسد عليه ، حيث أصبح وحيدا بعد أن جردته من أهم قادته ، عقب تدمير منظومة اتصالاته السرية.	OBJ
آخر حلقة في مسلسل تصفية هرم القيادة في حزب الله ، جاءت يوم الاثنين عندما نفذ الجيش الإسرائيلي ضربة استهدف فيها الرجل الثالث في الحزب وقائد الجبهة الجنوبية علي الكركي ، لكنه لم يمت بحسب بيان للجماعة المسلحة.	OBJ
وجاء استهداف كركي بعد أيام معدودة للضربة الجوية على الضاحية الجنوبية لبيروت ، والتي أدت إلى مقتل عدد من قادة قوة الرضوان العسكرية التابعة لحزب الله.	OBJ
"تصفية هرم القيادة وكشف الجيش الإسرائيلي ، في بيان السبت : "" تحت الأرض وفي قلب معقل حزب الله في بيروت : الجيش قضى على هرم قيادة "" قوة الرضوان "" في حزب الله الإرهابي ""."	OBJ
"وتابع : "" في غارة دقيقة مساء الجمعة ، هاجمت طائرات حربية تابعة لسلاح الجو بتوجيه استخباراتي من هيئة الاستخبارات ، وقضت على رئيس منظومة العمليات وقائد "" قوة الرضوان "" التابعة لحزب الله الإرهابي المدعو إبراهيم عقيل خلال اجتماع مع قادة في قوة الرضوان في الضاحية الجنوبية ""."	OBJ
"وأوضح : "" إلى جانب المدعو إبراهيم عقيل ، تم القضاء في الغارة على 15 إرهابيا آخر من حزب الله ومن بينهم قادة كبار في هرم قيادة قوة الرضوان ""."	OBJ
وأعلن حزب الله ليل الجمعة أن 15 من عناصره قتلوا على يد قوات إسرائيلية ، إلا أنه لم يسهب بشأن الهجوم.	SUBJ
"وقال محرر الشؤون الإسرائيلية في سكاي نيوز عربية نضال كناعنة : "" ما تقوم به إسرائيل هي تصفية هيئة أركان حزب الله بالكامل ، فقد صفت كل قيادة الصف الأول ، وهنالك العديد من قيادات الصف الثاني تم تصفيتها كقائد وحدة الرضوان إبراهيم عقيل ، وبالتالي تبدأ إسرائيل باستهداف هرم حزب الله من الأعلى ""."	OBJ
هل تصل الاغتيالات لنصر الله ؟	SUBJ
"وأضاف كناعنة أنه "" لم يتبق في القيادة العليا لحزب الله تقريبا إلا الأمين العام حسن نصر الله."	SUBJ
ولم يستبعد محرر الشؤون الإسرائيلية أن تصل سلسة الاغتيالات إلى حسن نصر الله ، في ظل إبداء إسرائيل أكثر من مرة نيتها بتصفيته وهو ما يفسر اختفاء أمين عام حزب الله منذ حرب 2006.	OBJ
"وأردف قائلا : "" إسرائيل الآن تظهر تفوقا استخباراتيا بشكل حاسم على حزب الله."	SUBJ
وفي الجهة الأخرى لا يفهم سر هذه التراخي الأمني لدى قيادات حزب الله ؟	SUBJ
) فشخص بمستوى علي كركي وهو المسؤول عن الجبهة الجنوبية وهي الجبهة الأهم الآن رأي الكثير من عمليات الاغتيال تحدث لقيادات يعرفهم ويجلس معهم تقريبا بشكل يومي.	SUBJ
"الآن يتم اغتيال آخر قائد كبير في حزب الله ، ونصر الله في موقف لا يحسد عليه ""."	SUBJ
حدد الملياردير الأميركي ، ومؤسس شركة بريدجووتر أسوشيتس ، راي داليو ، القوى الخمس الكبرى التي تشكل الاقتصاد العالمي.	OBJ
158 تريليون دولار في المدفوعات للعام بأكمله.	OBJ
"هناك اختلافات لا يمكن التوفيق بينها بين اليمين واليسار ، ناجمة عن فجوات كبيرة في الثروة والقيم ، وهو ما يثير تساؤلات حتى حول انتقال السلطة بشكل منظم ""."	OBJ
"ولأول مرة في دورة انتخابات 2024 ، أصبحت نائبة الرئيس كامالا هاريس الآن أكثر احتمالا للفوز من الرئيس السابق دونالد ترامب ، وفقا لاستطلاع رأي بنك الاحتياطي الفيدرالي الذي أجرته شبكة "" سي إن بي سي الأميركي "" ونشر الثلاثاء."	OBJ
وفي الأسبوع الماضي ، ناقش المرشحون قضايا تتراوح من حقوق الإجهاض إلى التعريفات الجمركية ومقترحات السياسة الأخرى.	SUBJ
ومع ذلك ، وبغض النظر عمن يشغل البيت الأبيض ، فإن أجندة سياسة الرئيس لها تأثير محدود على الصحة العامة للاقتصاد الأميركي.	SUBJ
وأكد أن تكلفة تغير المناخ على وشك الارتفاع ، فوفقا للمنتدى الاقتصادي العالمي ، فإن أزمة المناخ تؤدي إلى خسارة 12 بالمئة من الناتج المحلي الإجمالي العالمي لكل درجة مئوية واحدة من الارتفاع في درجات الحرارة.	OBJ
"وأضاف : "" من يفوز في حرب التكنولوجيا سيفوز في الحرب العسكرية ""."	SUBJ
"وفي تقييمه للعوامل الخمسة ككل ، خلص داليو إلى "" أن المفاجآت كانت أكثر سلبية من الإيجابية "" ، على حد قول تحديات عالمية من جانبه ، يؤكد مستشار المركز العربي للدراسات والبحوث ، أبو بكر الديب ، في تصريحات خاصة لموقع "" اقتصاد سكاي نيوز عربية "" ، أن العوامل التي هددت الاقتصاد العالمي خلال الفترة الماضية مازالت مستمرة على المدى المتوسط وربما تداعياتها تمتد لسنوات عدة."	OBJ
وقال إن من أبرز هذه التحديات : التوترات الجيوسياسية السلبية كالحرب في أوكرانيا ، وفرض أميركا وحلفائها الأوروبيين أكثر من 14 ألف عقوبة على روسيا ، وكذلك الحرب في غزة ، إضافة إلى الحرب بالوكالة بين إيران وإسرائيل وتهديد الملاحة بباب المندب والبحر الأحمر.	OBJ
ارتفاع أسعار الفائدة لفترات طويلة.	SUBJ
وشدد على ضرورة أن يقوم صناع السياسات بتحديد الخطوات ذات الأولوية نحو اكتساب مزيد من الصلابة الاقتصادية مثل تعزيز مالية الحكومة وإنعاش آفاق النمو الاقتصادي ، والتحول للاقتصاد الأخضر وضخ استثمارات كبيرة فيه وتخفيض الانبعاثات الكربونية.	OBJ
وذكر أن من الملاحظ توجه الدول الكبرى نحو استقطاب الاستثمارات وعدم التقوقع ، وأوضح على سبيل المثال : الصين بدأت الآن فتح قطاع التصنيع بالكامل أمام الاستثمارات الأجنبية ، وتمد مشروعها العملاق طريق الحرير ، لدعم مشروعات البنية الأساسية في دول الجوار والدول النامية الأخرى ، من خلال تقديم التمويل اللازم لهذه المشروعات عبر آلية القروض.	OBJ
الدول الغربية تتحول بشكل متسارع نحو اعتماد الطاقة الخضراء وتخفيض فوائد البنوك وإنعاش الدورة الاقتصادية المقبلة.	SUBJ
الذكاء الاصطناعي والمستقبل وبشأن توقعاته حول المشهد الاقتصادي العالمي خلال المرحلة المقبلة ، أفاد بأنه : في المرحلة المقبلة لم يعد هناك قطاع اقتصادي لن يمسه الذكاء الاصطناعي أو التطبيقات التي قد يتيحها.	OBJ
هناك أكثر من 300 ألف وظيفة سيغيرها الذكاء الاصطناعي بحلول العام 2030 أي بعد ست سنوات.	OBJ
كذلك من المرجح أن يتم تعزيز الإنتاجية في عديد من الصناعات ودمج قدرات الذكاء الاصطناعي في العمليات الحالية ، مثل البرامج ، لسرعة إنجاز المهام.	OBJ
سنشهد كذلك أن قطاعي التكنولوجيا والمالية قد يكونان من بين القطاعات الاقتصادية الأكثر تطورا عبر الذكاء الاصطناعي في السنوات القليلة المقبلة ، بينما سيشمل ذلك الموارد الطبيعية وتكنولوجيا المناخ والزراعة.	OBJ
وأكد أن كل هذه التغييرات تعتمد على الاستقرار الدولي وعلاقة الولايات المتحدة الأميركية مع باقي دول العالم الصناعية والتزاماتها.	SUBJ
للشهر الثاني على التوالي ، أظهر استطلاع رأي صحيفة فاينانشال تايمز وميشيغان روس ، أن هاريس تتمتع بميزة محدودة على ترامب في إدارة الاقتصاد ، حيث قال 44 بالمئة من الناخبين المسجلين إنهم يثقون في نائبة الرئيس الديمقراطي للتعامل مع الاقتصاد ، بينما أيد 42 بالمئة الرئيس الجمهوري السابق ، وفي الشهر الماضي ، تقدمت بنسبة 42 بالمئة مقابل 41 بالمئة.	OBJ
من بين أولئك الذين قالوا إنهم لم يشاهدوا المناظرة ، كان لترامب ميزة ، حيث وثق 41 بالمئة بالرئيس السابق و35 بالمئة فقط فضلوا هاريس.	SUBJ
يأتي ذلك قبل خفض بنك الاحتياطي الفيدرالي الأميركي لأسعار الفائدة المتوقع على نطاق واسع ، وهي إشارة إلى ثقته في أن فترة التضخم المرتفع قد تم التغلب عليها وأن البنك المركزي واستمرت نتائج الاستطلاع في إظهار أن هاريس تحظى بثقة أكبر بكثير من رئيسها ، الرئيس الأميركي جو بايدن ، فيما يتعلق بالاقتصاد.	OBJ
ويعتقد الناخبون بأن هاريس تمثل مصالح الطبقة المتوسطة بشكل أفضل بهامش كبير ( 49 بالمئة مقابل 36 ) وكذلك الشركات الصغيرة ( 48 بالمئة مقابل 37 ) وأعضاء النقابات ( 45 بالمئة مقابل 35 ) والعمال ذوي الياقات الزرقاء ( 43 بالمئة مقابل 36 ).	OBJ
وضع مالي أفضل مع ترامب وعلى الرغم من هذه المزايا ، لا يزال الناخبون يعتقدون بأنهم سيكونون في وضع مالي أفضل إذا أعيد انتخاب ترامب ، حيث قال 40 بالمئة منهم إنهم سيكونون في وضع أفضل إلى حد ما أو كثيرا تحت رئاسته ، وقال 35 بالمئة فقط إنهم سيكونون في وضع أفضل تحت قيادة هاريس	OBJ
في منتدى التعاون الصيني الأفريقي الذي بدأ في الرابع من سبتمبر ، تسعى بكين مرة أخرى إلى تعميق ارتباطها بدول الجنوب العالمي.	SUBJ
ولحسن الحظ ، كان الزعيم الصيني شي جين بينغ ثاقب البصيرة في إدراك الإحباطات والتطلعات داخل القارة السمراء النامية واستغل تلك المشاعر لبناء النفوذ السياسي والاقتصادي العالمي للصين ، بحسب تقرير للمجلس الأطلسي.	OBJ
"الحدث الذي يستمر ثلاثة أيام ، والذي وصفته وزارة الخارجية الصينية بأنه "" أكبر حدث دبلوماسي تستضيفه الصين في السنوات الأخيرة "" ، ليس سوى واحد من سلسلة من البرامج والمبادرات والتجمعات التي أطلقتها بكين لتوثيق روابطها الدبلوماسية والتجارية مع دول في جميع أنحاء الجنوب العالمي."	OBJ
على مدى العامين الماضيين ، خضع نهج شي جين بينغ تجاه العالم النامي لتغيير كبير : فقد أصبحت الصين بشكل متزايد مهووسة بالتنافس الجيوسياسي مع الولايات المتحدة وحلفائها وشركائها.	OBJ
هذا التحول سيكون له عواقب كبيرة على علاقات بكين مع الجنوب العالمي ، ودور الصين في النظام الدولي ، ومستقبل مسار قوتها العالمية.	OBJ
"ووفق تقرير المجلس ، فإن : الهدف من "" استراتيجية شي "" هو بناء تحالف من الدول داخل الجنوب العالمي ليكون بمثابة ثقل موازن لنظام التحالف العالمي الأميركي وقاعدة لتعزيز المصالح السياسية والاقتصادية والأيديولوجية للصين."	OBJ
يريد شي تقويض النظام الدولي القائم على القواعد الذي تقوده الولايات المتحدة من خلال إنشاء نظام بديل بقيادة الصين قائم على مبادئ سياسية غير ليبرالية يمكنها من دحر نفوذ الولايات المتحدة وتشكيل حوكمة عالمية من خلال المؤسسات والمنتديات الدولية ، على حد وصف التقرير.	OBJ
لقد أدى هذا الهدف إلى تعزيز أهمية الجنوب العالمي في السياسة الخارجية الصينية.	SUBJ
ما الذي يدفع الصين لتوسيع نطاق تواجدها في الجنوب العالمي ؟	SUBJ
يشير تقرير المجلس إلى أن التغيير في نهج بكين تجاه الجنوب العالمي هو جزء من معاداة شي المتزايدة لأميركا ، والتي تشكل معظم جوانب برنامجه السياسي في الداخل والخارج.	SUBJ
"كما أن التركيز المتزايد من جانب شي على "" الاكتفاء الذاتي "" الاقتصادي وتطوير التقنيات المحلية من خلال البرامج الصناعية التي تقودها الدولة مصمم للقضاء على نقاط ضعف الصين في مواجهة العقوبات المحتملة من واشنطن."	OBJ
وفي سياسته الخارجية ، تحدى شي بشكل أكثر صراحة النظام الذي تقوده الولايات المتحدة ، على سبيل المثال ، من خلال الترويج لإطاره الأيديولوجي لإعادة تشكيل الحوكمة العالمية من خلال مبادرته للأمن العالمي ومبادرة التنمية العالمية.	OBJ
في البداية ، كان الغرض الأساسي لشي في نهجه تجاه الجنوب العالمي هو تعزيز الروابط السياسية والاقتصادية الصينية مع البلدان النامية لتعزيز المصالح العالمية للصين.	OBJ
وتهدف مشاركة الصين في المنتديات مثل منظمة شنغهاي للتعاون وترويجها أيضا إلى تعزيز مثل هذه العلاقات ، فضلا عن تعزيز صوت البلدان النامية في الشؤون الدولية.	OBJ
ومن خلال كل هذه المبادرات ، كان شي يعتزم تصوير الصين كبديل للولايات المتحدة وشركائها وكبطل لمصالح الدول الأكثر فقرا في العالم.	SUBJ
التحول الذي يقوده شي لقد بدأ التحول في نهج شي يصبح واضحا مع اندلاع الحرب في أوكرانيا.	SUBJ
وبمجرد أن دخلت دبابات روسيا إلى أوكرانيا بعد ثلاثة أسابيع ، أصبحت هذه النتيجة حتمية.	SUBJ
فقد حفزت الحرب شراكات الأمن بين حلف شمال الأطلسي والولايات المتحدة ودول المحيطين الهندي والهادئ ، مما سمح للرئيس الأميركي جو بايدن بسد بعض الخلافات داخل هذه التحالفات فيما يتصل بالسياسة تجاه الصين.	OBJ
شراكة اقتصادية أم استعمار ناعم ؟	SUBJ
ونتيجة لهذا ، تمكنت الولايات المتحدة وشركاؤها في أوروبا ومنطقة المحيطين الهندي والهادئ من صياغة موقف أكثر تنسيقا وتماسكا فيما يتصل بسياسة الصين.	OBJ
وكلما سعى شي إلى إقامة علاقات أقوى مع بوتين ، حتى مع استمرار الحرب في أوكرانيا ، أصبحت سياسة حلفاء الولايات المتحدة تجاه الصين أكثر صرامة.	SUBJ
فخلال قمة مجموعة السبع الأخيرة ، على سبيل المثال ، حذر زعماء المجموعة الصين جماعيا من ضرورة وقف المساعدات المقدمة إلى روسيا والتي تدعم جهود موسكو الحربية أو مواجهة العقوبات.	OBJ
كان قرار شي بالتحالف مع بوتين خيارا واعيا ، وليس مفروضا عليه.	SUBJ
فقبل الحرب في أوكرانيا ، لم يكن زعماء أوروبا متفقين على رأي واحد بشأن الصين ، ولم يكونوا متفقين تماما مع موقف واشنطن.	SUBJ
وكانت بكين تحرز تقدما في استغلال هذه الخلافات لتقسيم الولايات المتحدة وحلفائها الأوروبيين بشأن القضايا المتعلقة بالصين.	SUBJ
ويضيف التقرير في معرض تحليل السياسات الصينية : كان شي على استعداد للانفصال عن الولايات المتحدة وحلفائها من أجل تحقيق هدف أكبر : تقويض النظام الدولي الحالي.	SUBJ
ويبدو أنه يرى روسيا كمواطنة حاسمة في هذا المسعى.	SUBJ
"قال شي لبوتين خلال زيارة إلى موسكو في عام 2023 : "" التغيير قادم لم يحدث منذ 100 عام."	SUBJ
التكتلات الأساسية أصابت نفس هذه الأفكار استراتيجية شي الشاملة في الجنوب العالمي.	SUBJ
فلم يعد يكتفي ببناء النفوذ بين البلدان النامية ، أو حتى تقديم الصين كبديل ، بل يسعى الآن إلى تجنيد قادتها في حركته المناهضة لأميركا.	SUBJ
شراكة أم حرب نفوذ مع الغرب ؟	SUBJ
وتتجلى هذه الأجندة بشكل واضح في تقدم مجموعة البريكس للدول النامية.	SUBJ
( أضيفت جنوب إفريقيا في وقت لاحق ).	SUBJ
وفي العام الماضي ، نجح شي في الدفع نحو توسيع عضوية المجموعة.	SUBJ
وفي إطار الحفاظ على الروح الأولية للمنتدى ، يتبادر إلى الذهن بعض المرشحين الواضحين.	SUBJ
وتبرز إندونيسيا ، وكذلك دول جنوب شرق آسيا الأخرى ، مثل تايلاند.	OBJ
كما تشكل نيجيريا احتمالا قويا.	SUBJ
ومع ذلك ، لم تتم دعوة هذه البلدان.	SUBJ
إن ما تشترك فيه هذه البلدان هو أن الصين تتمتع بنفوذ اقتصادي أو دبلوماسي عليها ، أو أنها تريد إغرائها بالدخول في شراكات أوثق.	SUBJ
تتمتع كل من مصر وإثيوبيا بعلاقات سياسية وثيقة مع الصين - وديون ثقيلة للمقرضين الصينيين.	SUBJ
تساعد بكين مصر في بناء عاصمة جديدة بالكامل.	SUBJ
تعتمد إيران ، تحت العقوبات الغربية ، مثل روسيا ، على الدعم الدبلوماسي والاقتصادي الصيني.	OBJ
في وقت التوسع ، كانت الأرجنتين تتجنب التخلف عن سداد القروض من صندوق النقد الدولي من خلال استغلال الأموال من البنك المركزي الصيني.	OBJ
ومن الواضح أن بكين تتودد إلى السعوديين والإماراتيين كشركاء في الشرق الأوسط.	SUBJ
في منتدى الحزام والطريق الأخير ، الذي عقد في أكتوبر 2023 في بكين للاحتفال بالعقد الأول من البرنامج ، تحدث زعماء من ثلاث دول من مجموعة البريكس - روسيا وإثيوبيا والأرجنتين - في حفل الافتتاح.	OBJ
وتؤكد بكين باستمرار على أن دول البريكس يجب أن تتحد وراء أجندة لتعزيز مصالح الجنوب العالمي - والصين.	SUBJ
ومن المؤشرات على ذلك القرار الذي اتخذه الرئيس الأرجنتيني الجديد برفض الدعوة للانضمام إلى مجموعة البريكس.	SUBJ
وكلما زادت معاداة شي لأميركا في سياساته ، كلما تعرضت علاقات بكين بالعالم النامي لضغوط أكبر.	SUBJ
بطبيعة الحال ، وبشكل علني ، تضغط بكين على حكومات الجنوب العالمي لاتخاذ موقف ضد الولايات المتحدة.	SUBJ
كما دفع تصاعد معاداة شي لأميركا إلى اتخاذ قرارات مشكوك فيها استراتيجيا.	SUBJ
فقد رفضت بكين نداءات واشنطن للانضمام إلى تحالف دولي لقمع الاضطرابات في البحر الأحمر التي تسبب فيها الحوثيون ، الذين كانوا يتصيدون السفن المارة عبر قناة السويس.	OBJ
ويبدو أن تقاعس بكين نابع من تفضيلها لاستخدام أزمة البحر الأحمر لمهاجمة السياسة الأميركية في الشرق الأوسط.	SUBJ
ومع ذلك ، فإن التكلفة قد تقوض ادعاء بكين بأنها لاعب أكثر مسؤولية في الشرق الأوسط من الولايات المتحدة وتزعج شركاء مهمين لا يدعمون الحوثيين ، وفق التقرير.	SUBJ
لا شك أن زعماء الجنوب العالمي سوف يكونون حساسين لمحاولات الصين استخدامهم كأدوات في لعبة جيوسياسية ضد الولايات المتحدة.	SUBJ
وهذا من شأنه أن يفتح فرصا محتملة أمام واشنطن لتقديم الولايات المتحدة باعتبارها أكثر شمولا من خلال تشجيع الحوار بين الشمال والجنوب.	SUBJ
ومن الممكن أن تقطع الجهود الرامية إلى وفي الفترة التي سبقت قمة السلام الأوكرانية التي عقدت في سويسرا في يونيو ، والتي رفضت الصين حضورها ، ورد أن الدبلوماسيين الصينيين ضغطوا على الدول النامية لدعم اقتراح صيني بديل للسلام.	OBJ
"يشير تقرير المجلس الأطلسي إلى أن واشنطن كانت مذنبة بارتكاب سلوك مماثل ، لكن صناع السياسات في الولايات المتحدة أدركوا أن مثل هذه الأساليب "" معنا أو ضدنا "" يمكن أن تأتي بنتائج عكسية مع عزم أعضاء الجنوب العالمي على رسم مسار مستقل في الشؤون العالمية."	SUBJ
ويتجلى هذا الإدراك في مرونة إدارة بايدن في العلاقات مع الهند ، على سبيل المثال.	SUBJ
إذا حاول نهج الصين تجاه الجنوب العالمي إجبار نخبها السياسية على الانحياز إلى أي من الجانبين ، فقد تقوض بكين جهودها الخاصة لجذب دعمهم.	SUBJ
قد تنضم بعض الدول عن طيب خاطر إلى أجندة بكين المناهضة لأميركا ، مثل روسيا وإيران ، وكلاهما منفصلان بالفعل عن الغرب.	SUBJ
في استطلاع حديث أجري في تايلاند ، شعرت نسبة مماثلة من المستجيبين ( حوالي ثلاثة أرباع ) أن الولايات المتحدة والصين تفعلان المزيد من الخير أكثر من الضرر للأمن في آسيا ، وهو مؤشر على وجهات النظر المتوازنة التي يتبناها الناس في تلك الدولة المهمة في جنوب شرق آسيا حتى مع تكثيف المنافسة بين القوتين.	OBJ
تحولت أحلام النجم الواعد لمنتخب تونس حنبعل المجبري بشكل لافت مع مانشستر يونايتد الإنجليزي إلى ما يشبه الكوابيس بعدما خرج لاعب خط الوسط نهائيا من حسابات مدربه الهولندي إيريك تين هاغ خلال المباريات الأولى للموسم الجديد.	OBJ
وبعد نحو 3 سنوات على انتقاله إلى مانشستر يونايتد ، قادما من موناكو الفرنسي ، رجح الكثير من العارفين بكرة القدم الإنجليزية أن نجم المجبري ، الذي كان يبلغ من العمر 18 عاما عندما بدأ تجربته في مانشستر ، سيسطع بقوة في سماء الدوري الإنجليزي الممتاز وأنه سيصبح واحدا من معشوقي جماهير فريق الشياطين الحمر.	OBJ
معاناة ووضعية غامضة وتداولت الصحف الإنجليزية خلال الأسبوع الماضي عديد الأخبار بشأن ما اعتبرته غموضا في مستقبل لاعب منتخب تونس مع مانشستر يونايتد ، وأشارت إلى أن إدارة النادي تلقت عرضا من فريق بيرنلي في الدرجة الأولى لانضمام المجبري على سبيل الإعارة.	OBJ
وقالت نفس المصادر إن المجبري قد يخوض موسما آخر خارج أسوار مانشستر يونايتد بعد أن قرر الجهاز الفني تركه خارج الحسابات في مباراة نهائي كأس الدرع الخيرية أمام مانشستر سيتي ثم مباراة الجولة الأولى للدوري الأسبوع الماضي أمام فولهام.	OBJ
أخبار ذات صلة وقبل أسبوع على نهاية آجال انتقالات اللاعبين في الدوريات الأوروبية تبدو وضعية اللاعب التونسي صعبة ومستقبله غامضا في انتظار أن تحدد الأيام المقبلة وجهته الجديدة.	OBJ
ويبدو أن مستوى الدوري الإنجليزي بشكل عام ونسق مانشستر يونايتد القوي هو السبب الأول في تعثر خطوات المجبري في فريق الشياطين الحمر وعدم قدرته على إثبات نفسه حتى ضمن التشكيلة الاحتياطية بحسب رأي المدير الفني السابق للاتحاد التونسي لكرة القدم كمال القلصي.	OBJ
"وتابع القلصي : "" المجبرى لا يزال قادرا على بناء مسيرة كروية لافتة خصوصا أنه مازال في الحادية والعشرين من العمر وأمامه الفرصة لكي يختار الفريق الذي يناسبه بعيدا عن الدوري الإنجليزي ، بإمكانه أن يدرس عروضا من دوريات أخرى مثل فرنسا أو ألمانيا ، لاعبو البريمرليغ يخوضون معدل مباريات يفوق 60 مباراة في الموسم الواحد وهو رقم مرتفع جدا وبعيد عن إمكانيات المجبري الفنية والبدنية ""."	OBJ
خارج حسابات نسور قرطاج وألقت الوضعية الغامضة للمجبري مع منتخب تونس بظلالها على مسيرته الدولية مع منتخب نسور قرطاج حيث كان الغائب الأبرز في المباريات الأخيرة لتونس في تصفيات كأس العالم 2026 وكأس إفريقيا 2025.	OBJ
وبسبب غيابه عن مباريات فريقه في الموسم الماضي ، سواء مع المان يونايتد أو بعد الإعارة لإشبيلية ، لم يوجه الجهاز الفني للمنتخب التونسي الدعوة للمجبري للمشاركة في كأس إفريقيا الكامرون 2024 ، مما أثار ضجة كبيرة في ذلك الوقت وسط اتهامات للاعب بأنه رفض اللعب مع النسور حتى يسترجع مكانه في تشكيلة المان يونايتد.	OBJ
وخاض مع منتخب تونس 27 مباراة دولية ، كما شارك في كأس العرب للمنتخبات في 2021 وكأس العالم قطر 2022 ، قبل أن يتخلف عن المشاركة في بطولة كأس الأمم الإفريقية الأخيرة.	OBJ
"تتعهد هاريس بضمان بناء 3 ملايين منزل "" ميسور التكلفة "" إضافي للطبقة المتوسطة على مدى أربع سنوات ، وهو وعده وصفه مقال للمعلق الاقتصادي في صحيفة فاينانشال تايمز ، كريس جايلز ، بالخجول والمخيب للآمال."	OBJ
يقول كاتب المقال إن ما يثير القلق أكثر هو اختيارها لمغازلة الشعبوية الاقتصادية اليسارية ، وحديثها الغامض عن سياسات من شأنها أن تعادل فرض ضوابط على أسعار البقالة وضوابط على الإيجارات.	SUBJ
كذلك فإن التعريفات الجمركية الأعلى تؤثر على المستهلكين الأميركيين ومن شأنها أن ترفع الأسعار ، وكانت دعوته ( ترامب ) إلى فرض رسوم جمركية تتراوح بين 10 و20 بالمئة على الدول الأجنبية ، أمرا خطيرا على الاقتصاد الأميركي والعالمي ، ومع حرص الجمهوريين على خفض الضرائب أكثر من حرصهم على ضبط الإنفاق ، فلا ينبغي لأحد أن يكون على يقين من استقرار الاقتصاد الأميركي في ظل رئاسة ترامب حتى لو كان الكونغرس قادرا على كبح جماح العديد من غرائزه.	OBJ
الإنفاق الحكومي : وهي مشكلة هائلة تواجهها الولايات المتحدة لاستدانة الحكومة بشكل مفرط رغم انتهاء الحروب التي انخرطت فيها أميركا ، وانتهاء أزمة كورونا ، لذا على أي رئيس قادم أن ينظر لها كمشكلة حقيقية في ظل عدم وجود أسباب منطقية لأن يكون بزخ حكومي بهذا التنامي والارتفاع المستمر بدلا من أن ينكمش ، وهو سؤال يجب الإجابة عنه بشكل سريع فالمواطن الأميركي يتململ من الحكومات التي تستدين باسمه للإنفاق على مشاريع لا يعتبرها ضرورية ولا تؤثر بشكل إيجابي على معيشته.	OBJ
أخبار ذات صلة الطرف الجمهوري واضح بخصوص هذا الشأن عن طريق خفض الضرائب لتستطيع الشركات توظيف المزيد من الأشخاص.	SUBJ
أما بالنسبة للطرف الديمقراطي فهو غير واضح ، هناك حديث عن وجود دعم حكومي للأفراد ، لكن المواطن لا يبحث عن دعم حكومي لكنه يرغب في أن تتوفر له فرصة عمل ذات دخل جيد ، خاصة وأن التضخم الكبير في أسعار السلع خلال السنوات الماضية وكلفة الحياة بشكل العام يأتي في ظل مستوى أجور لا يعكس ذلك ، ولا يوجد هذا الارتفاع الملموس في مستوى الأجور ، لذا يجب على الإدارة القادمة النظر لهذه المشكلة.	OBJ
"تحديات اقتصادية من جهته ، أوضح مستشار المركز العربي للدراسات والبحوث ، أبو بكر الديب ، في تصريحات خاصة لموقع "" اقتصاد سكاي نيوز عربية "" ، أن ثمة عدة تحديات اقتصادية تواجه الرئيس الأميركي القادم ومن أهمها : ارتفاع حجم الدين بشكل كبير ليصل إلى 34."	OBJ
50 تريليون دولار ارتفاع عجز الموازنة وتباطؤ النمو الاقتصادي.	OBJ
علاوة على ارتفاع معدلات البطالة.	SUBJ
السياسة النقدية المتشددة ورفع الفائدة بعد أزمتي كورونا والحرب في أوكرانيا حيث تم رفع أسعار الفائدة 11 مرة بين مارس 2022 إلى أن استقر سعر الفائدة على الأموال الفيدرالية بين 5.	OBJ
إنفاق أكثر من 200 مليار دولار لدعم أوكرانيا دون حسم الملف.	OBJ
فقدان حلفاء تقليديين مع صعود اليمين المتطرف في أوروبا.	SUBJ
علاوة على زيادة التوتر مع الصين وقضايا غزة والملف النووي الإيراني وقضايا الهجرة غير الشرعية ومواجهة تكتل بريكس بتشكيلته الجديدة ، وقضايا التغير المناخي والتوتر مع روسيا في بحر البلطيق وغيرها من القضايا.	OBJ
هل ينجح الرئيس الأميركي القادم في إصلاح ما أخفق فيه بايدن ؟	SUBJ
أعربت الإدارة الأميركية عن قلقها البالغ إزاء التقارير الإسرائيلية التي تتحدث عن استخدام الجيش المدنيين في غزة كغطاء لعملياته العسكرية داخل الأنفاق مشيرة إلى أنها تحقق في هذه المزاعم.	OBJ
كما وجهت أصابع الاتهام إلى حماس باستغلال المدنيين في القطاع كدروع بشرية ، مشددة على ضرورة نجاح مفاوضات وقف إطلاق النار في غزة ، لوقف المعاناة.	OBJ
"وفجر تحقيق لصحيفة "" هآرتس "" بعنوان الجيش الإسرائيلي يستخدم مدنيين فلسطينيين لتفتيش أنفاق مفخخة محتملة في غزة ، ليحلوا محل وحدات مختصة بالبحث عن المتفجرات وقتل عدد كبير منها."	OBJ
"أخبار ذات صلة وقالت منظمة كسر الصمت الإسرائيلية التي توثيق الانتهاكات العسكرية إن هذه الممارسات كانت منتشرة على نطاق واسع في مختلف الوحدات التي تقاتل في غزة لدرجة أنه يمكن اعتبارها "" بروتوكولا ""."	OBJ
"حماس كان لها رأي في تحقيق "" هآرتس "" إذ طلبت من محكمة العدل الدولية ضم الاعترافات لملف "" جرائم الحرب "" التي تلاحق إسرائيل ، على الرغم من أن تل أبيب اتهمت الحركة منذ بداية الحرب الحركة بالتواري بين التجمعات المدنية وتنفيذ هجماتها على إسرائيل من خلالهم."	OBJ
كما تكشف روايات شهود عيان أن حماس تستخدم المدنيين كغطاء لعملياتها وتجبرهم على الاختباء بينهم خصوصا في المستشفيات والمدارس والمساجد والمرافق المدنية الأخرى.	SUBJ
وبحسب تقرير لشبكة cbsnews ، اطلعت عليه سكاي نيوز عربية ، ستدعو هاريس إلى بناء 3 ملايين وحدة سكنية جديدة في أول أربع سنوات لها في منصبها.	OBJ
وهذا جزء من سياستها الاقتصادية التي من المتوقع أن تطرحها في رالي بولاية نورث كارولينا ، كما أكد مسؤولون في الحملة.	SUBJ
كما ستدعو هاريس إلى تقديم حافز ضريبي جديد لشركات البناء التي تبني العقارات للمشترين لأول مرة ، وستقترح إنشاء صندوق بقيمة 40 مليار دولار لمساعدة الحكومات المحلية في إيجاد حلول لنقص المعروض من المساكن.	OBJ
وكانت صحيفة وول ستريت جورنال أول من نشر تقارير عن مبادرات الإسكان التي اقترحتها هاريس.	SUBJ
وقال مسؤولون في الحملة إن هاريس ستدعو الكونغرس إلى تمرير قانون منع تسهيل كارتلات الإسكان الإيجاري ، والذي من شأنه أن يمنع أصحاب العقارات من استخدام خوارزميات تحديد الأسعار لزيادة الإيجارات.	OBJ
كما تريد من المشرعين تمرير قانون من شأنه أن يحد من الإعفاءات الضريبية للمستثمرين الكبار وشركات الأسهم الخاصة التي تستحوذ على منازل الإيجار للعائلات الفردية بكميات كبيرة.	OBJ
فيما لا تزال الأسعار أعلى بنسبة 20 بالمئة بشكل عام مما كانت عليه قبل جائحة كوفيد - 19.	SUBJ
وتأتي تصريحاتها بشأن السياسة الاقتصادية يوم الجمعة بعد أن تعهدت هاريس بإلغاء الضرائب على الإكراميات ورفع الحد الأدنى للأجور خلال تجمعها الانتخابي في لاس فيغاس يوم السبت ، وهما مقترحاها الوحيدان بشأن السياسة الاقتصادية حتى الآن.	OBJ
"إلغاء الضرائب على الإكراميات وقالت هاريس الأسبوع الماضي : "" عندما أصبح رئيسة ، سنواصل نضالنا من أجل الأسر العاملة بما في ذلك رفع الحد الأدنى للأجور وإلغاء الضرائب على الإكراميات للعاملين في مجال الخدمة والضيافة ""."	OBJ
وأضاف مسؤول في حملة هاريس - فالز أن تعهدها سيتطلب تشريعا.	SUBJ
في العام 2025 ، من المقرر أن يحظى المشرعون بانفتاح كبير فيما يتعلق بالتشريعات الضريبية نظرا لانتهاء بعض التغييرات الضريبية التي أجريت خلال رئاسة ترامب في عام 2017.	OBJ
وسوف تكون السيطرة على الكونغرس أمرا أساسيا في هذه القضية نظرا لأن الجمهوريين كانوا يسيطرون على مجلس النواب ومجلس الشيوخ والبيت الأبيض عندما أصبحت التخفيضات الضريبية التي أقرها ترامب في عام 2017 قانونا.	OBJ
"وبحسب تقرير نشرته "" بلومبرغ "" واطلع عليه موقع "" اقتصاد سكاي نيوز عربية "" ، فقد اكتشف الباحثون أنه عندما يتم تدريب أنظمة الذكاء الاصطناعي ، باستخدام بيانات تم إنشاؤها بواسطة الذكاء الاصطناعي ، فإن أداء هذه الأنظمة يتدهور بشكل ملحوظ ، وهي الظاهرة التي يطلق عليها الخبراء اسم ما هو انهيار النموذج ؟"	OBJ
تعتمد برامج الدردشة التي تعمل بالذكاء الاصطناعي مثل ChatGPT على نماذج لغوية ضخمة ، تم تدريبها على تريليونات البيانات التي تم إنشاؤها من قبل الإنسان ، وقد تم الاستحصال على هذه البيانات من صفحات الويب والمقالات ، والتعليقات المنتشرة على شبكة الانترت.	OBJ
"وبفضل هذه الكميات الضخمة من البيانات ، تمكنت شركات "" أوبن أيه آي "" و "" ألفابت "" و "" ميتا "" وغيرها من الشركات ، من تصميم برامج يمكنها تقديم إجابات واضحة على استفسارات المستخدمين."	OBJ
"ولكن ولإشباع شهية برامج الذكاء الاصطناعي التوليدي التي لا تشبع من التغذية بالبيانات ، حاول الباحثون وبشكل متزايد في الآونة الأخيرة ، تزويد هذه البرامج ببيانات "" اصطناعية "" ، أي من صنع الذكاء الاصطناعي نفسه ، ليتبين للمراقبين أن هذه البرامج تنهار وتنتج معلومات مشوهة عندما يتم تدريبها على محتوى لم يصنعه البشر."	OBJ
وقد شبه الباحثون هذه الظاهرة بتسميم الذكاء الاصطناعي لنفسه.	SUBJ
ماذا وجدت الورقة البحثية ؟	SUBJ
في الورقة البحثية الجديدة ، وجد الباحثون من أكسفورد وكامبريدج وجامعات أخرى أن برامج الذكاء الاصطناعي المدربة بمحتوى تم إنشاؤه بواسطة الذكاء الاصطناعي تصدر نتائج غير منطقية ، لتتفاقم هذه المشكلة في كل مرة يتم فيها تدريب هذه البرامج على بيانات اصطناعية ، مما يجعل النتائج التي تزود بها المستخدمين بعيدة كل البعد عن الواقع وأقرب إلى الهراء.	OBJ
المستقبل لمطوري البرامج و خبراء الأمن السيبراني وبحسب المؤلف الرئيسي للورقة البحثية إيليا شوميلوف وفريقه ، فإن الأمر يصبح أسوأ في كل مرة يتم فيها تغذية برامج الذكاء الاصطناعي ببيانات اصطناعية ، لينتهي الأمر ببيانات ملوثة وبرامج لا تدرك الواقع.	OBJ
وفي أحد الأمثلة على ما حصل ، أظهرت الورقة البحثية ، أن برنامج لغوي للذكاء الاصطناعي تم تدريبه عدة مرات على بيانات تم إنشاؤها بواسطة الذكاء الاصطناعي ، قام بتحويل استفسار عن الهندسة المعمارية البريطانية التاريخية إلى مناقشة غير مفهومة عن الأرانب البرية.	OBJ
ما مدى خطورة انهيار النموذج ؟	SUBJ
"تسببت استقالة محمد جواد ظريف من منصبه كنائب للرئيس الإيراني للشؤون الإستراتيجية ، في "" صدمة "" داخل الساحة السياسية الإيرانية ، خاصة التيار الإصلاحي."	OBJ
كما أثارت الاستقالة مخاوف من عودة الاحتجاجات والاضطرابات ، حيث كان ظريف المساعد الأقوى للرئيس مسعود بزشكيان خلال حملته الانتخابية ، وخلقا معا آمالا بانتعاش هذا التيار مقابل التيار المحافظ الذي يقوده المرشد الأعلى للبلاد ، علي خامنئي.	OBJ
"ويعتقد متخصصون في الشؤون الإيرانية في تعليقاتهم لموقع "" سكاي نيوز عربية "" على هذه الاستقالة المفاجئة ، أنها تشير إلى خيبة أمل الإصلاحيين تجاه حكومة مسعود بزشيكان ، وتساءل البعض ما إذا كانت الاستقالة تعكس تحول الرئيس الإيراني من شخصية إصلاحية إلى أداة في يد المرشد الأعلى ، وما إذا كانت تعكس سيطرة المرشد على الحكومة الجديدة."	OBJ
"واعتبرت وسائل إعلام إيرانية ، مثل "" صحيفة المشرق "" ، أن استبعاد المسؤولين ذوي الجنسية المزدوجة ، أو من يحمل أبناءهم جنسية مزدوجة من الحكومة ، ومنهم ظريف ، الذي يحمل أبناؤه الجنسية الأميركية ، يشير إلى ضغوط يتعرض لها بزشيكان من مكتب خامنئي."	OBJ
"وكان وقوف ظريف إلى جانب بزشكيان خلال انتخابات يونيو الماضي ، والتي كان فيه بزشكيان المرشح الإصلاحي الوحيد ، "" نقطة تحول ودعم قوي "" أمام المرشحين المحافظين الخمسة ، وكذلك رسالة للغرب بتغيير في السياسة الخارجية الإيرانية حال فوز بزشكيان ، لتكون أكثر مرونة في بعض الملفات الإقليمية والدولية."	OBJ
"ولم يلق التشكيل الحكومي الذي قدمه بزشكيان إلى البرلمان ، الأحد ، للموافقة عليه ، تقبلا من التيار الإصلاحي الذي يمثله ، حيث ضم امرأة واحدة ، كما ضم عددا من النواب المحافظين من الحكومة السابقة ظريف يشكو من "" الضغوط "" وفي توضيحه لأسباب استقالته ، قال جواد ظريف ، الذي تولى وزارة الخارجية من 2013 إلى 2021 ، في تدوينة على حسابه في موقع "" إكس "" ، الأحد : "" أشعر بالخجل لأنني لم أتمكن من تنفيذ رأي الخبراء للجان المسؤولة عن اختيار المرشحين بشكل لائق ، وتحقيق إشراك النساء والشباب والمجموعات العرقية كما وعدت ""."	OBJ
كذلك أشار إلى أن عددا من الوزراء في التشكيل الجديد الذي ضم 19 وزيرا لم يكونوا من اختياره.	SUBJ
أخبار ذات صلة استقالة ظريف.	SUBJ
هل رسب بزشكيان في أول اختبار ؟	SUBJ
وتحذر المحللة الإيرانية من أن يؤجج هذا الإحباط المشاعر السلبية في الشارع ، ويسبب تصعيدا جديدا في الاحتجاجات والاضطرابات.	SUBJ
أخبار ذات صلة رد طهران أم حزب الله ؟	SUBJ
"خلافات بين بزشكيان والحرس الثوري بزشيكان وعباءة خامنئي يتناول المؤرخ والمحلل السياسي الإيراني آرش عزيزي الوضع من زاوية تركز على الخلافات الداخلية ؛ حيث يرى أن استقالة ظريف "" ليست مجرد حدث سياسي عابر ، بل تدل على خلافات عميقة ، تكشف عدم التماسك في الإدارة العليا ""."	OBJ
ويتوقع عزيزي أن تنعكس هذه الخلافات على أداء الحكومة الجديدة ، لافتا بشكل خاص إلى ما يعتبره دورا محتملا لمكتب علي خامنئي في تأجيج أزمة داخل الحكومة.	SUBJ
"وعن دوافع خامنئي لذلك التدخل المحتمل ، يقول ، إن التدخل سواء كان خفيا أو علنيا "" يهدف إلى تعزيز سيطرته على الحكومة ، أو إخضاعها بالكامل ، وإذا تمكن من هذا ، قد يواجه بزشيكان صعوبة في حفظ مصداقية الحكومة أمام الشعب والمجتمع الدولي ""."	OBJ
"ويتفق مع هذا التحليل الخبير في الشأن الإيراني ، وجدان عبد الرحمن ، معتبرا أن استقالة جواد ظريف "" تكشف عن درجة عالية من السيطرة التي يمارسها مكتب المرشد الأعلى علي خامنئي والحرس الثوري على الحكومة "" ، متوقعا أيضا أن يؤثر هذا على استقلال الحكومة القادمة."	OBJ
""" مهندس الاتفاق النووي "" مساعدا للرئيس إيران."	OBJ
"ملفات ساخنة أمام بزشكيان أبرزها "" نفوذ خامنئي "" السودان عند "" نقطة انهيار كارثية "" والغموض يلف مفاوضات جنيف l 13 أغسطس 2024 - 05 : 46 بتوقيت أبوظبي سكاي نيوز عربية - أبوظبي مخيم للنازحين في مدينة كسلا حذرت المنظمة الدولية للهجرة التابعة للأمم المتحدة ، من أن السودان وصل إلى "" نقطة انهيار كارثية "" ، مع توقع تسجيل عشرات الآلاف من الوفيات التي يمكن تفاديها."	OBJ
"وأضاف "" من دون استجابة عالمية فورية واسعة النطاق ومنسقة ، فإننا نخاطر بأن نكون شاهدين على عشرات الآلاف من الوفيات التي يمكن تفاديها في الأشهر المقبلة."	SUBJ
"نحن عند نقطة الانهيار ، نقطة انهيار كارثية ""."	SUBJ
ويشهد السودان حربا منذ أبريل 2023 بين قوات الدعم السريع بقيادة محمد حمدان دقلو والجيش الذي يقوده عبد الفتاح البرهان ، أوقعت إلى الآن عشرات آلاف القتلى وأدت إلى أزمة إنسانية.	OBJ
3 مليون شخص عبر الحدود إلى الدول المجاورة.	OBJ
تزامنا مع كلمة أمين عام حزب الله اللبناني حسن نصر الله على شاشات التلفزة ، اهتزت منازل بيروت وأصيب الأطفال بالهلع نتيجة الصوت المدوي الذي خلفه الطيران العسكري الإسرائيلي فوق العاصمة اللبنانية عصر الثلاثاء.	OBJ
وسبق خرق جدار الصوت ، الذي حدث في بيروت مرات عديدة بشكل غير مسبوق ، الثلاثاء ، حالة من الذعر بين السكان الذين تركوا أعمالهم قبل الوقت المحدد لنهاية ساعات العمل ، خوفا من الرصاص العشوائي الذي يرافق إطلالة نصر الله في العادة ، إلا أن المفاجأة أتت من حالة الذعر التي خلفها الصوت المدوي.	OBJ
80 % Fullscreen ويعيش اللبنانيون منذ مدة الهلع بسبب شن الطيران الحربي الإسرائيلي غارات وهمية لخرق لجدار الصوت فوق الأراضي اللبنانية.	SUBJ
"ويبقى السؤال اليومي الروتيني على لسان اللبنانيين : "" هل سمعتم جدار الصوت ؟"	SUBJ
""" ، بعد تعمد إسرائيل فعل ذلك بشكل شوارع بيروت خالية تزامنا مع خرق جدار الصوت ويحدث اختراق الصوت دويا قويا مثل الغارة الجوية لكن من دون إلقاء قذائف ، ويتسبب برعب السكان ويؤدي إلى ارتجاج المباني تارة ، وتارة أخرى إلى تحطيم زجاجها ، فيعتقد السكان أن انفجارا وقع قريبا جدا منهم."	OBJ
"ويعد القيام بغارة وهمية أو خرق جدار الصوت نوعا من التدريبات التي تجريها الجيوش لتعليم طياريها كيفية الاشتباك والطيران بسرعات أعلى من سرعة الصوت التي تبلغ نحو 340 مترا في الثانية ، وفق حديث خبراء معنيين في هذا المجال لموقع "" سكاي نيوز عربية ""."	OBJ
"أيام ساخنة وتأتي هذه الطلعات الجوية وسط مخاوف اللبنانيين من انزلاق بلدهم في مستنقع الحرب الشاملة ، في ظل تصاعد التهديدات الإسرائيلية بأن "" أياما ساخنة "" بانتظارهم."	OBJ
"ويقول رجل الأمن المتقاعد مفيد علوان لموقع "" سكاي نيوز عربية "" : "" تستخدم إسرائيل هذا الإجراء التدريبي كوسيلة ترهيبية لإصدار أصوات مشابهة لصوت القصف ، وترافقها موجة ضغط تؤدي في بعض الأحيان ، إن كانت الطائرات على علو منخفض ، إلى تحطم زجاج الأبنية ، أو حتى التسبب بجروح داخلية في الأذنين ""."	OBJ
"ويتابع : "" يترافق جدار الصوت مع تشكل غيمة دائرية تحيط بالطائرة ، وتتكون من الاحتكاك العنيف للطائرة السريعة مع جزيئات الهواء ""."	OBJ
"أجواء مشحونة بالتصعيد وسط ترقب لرد حزب الله ويضيف : "" تسيطر حالة من الهلع على اللبنانيين عند سماعهم دوي أي انفجار أو صوت قوي ، حتى باتت المفرقعات النارية في المناسبات ترعبهم ، قبل التأكد من أنها للفرح والاحتفال ""."	OBJ
"ويقول ربيع المولى ، وهو من سكان مدينة النبطية جنوب البلاد ، لموقع "" سكاي نيوز عربية "" : "" بتنا ننتظر خرق جدار الصوت إذا تأخر."	OBJ
"أحيانا تخرق إسرائيل جدار الصوت على علو منخفض لأكثر من مرة في اليوم ، مما يثير الرعب بين السكان خصوصا الأطفال وكبار السن ""."	OBJ
"ويتابع : "" لا شك أن الأضرار النفسية بالغة ، إلا أن ضرره المادي بات واضحا على معظم البيوت التي تحطم زجاجها وبعضها تصدعت جدرانها ""."	SUBJ
"وقالت فاتن لموقع "" سكاي نيوز عربية "" : "" هرع طفلي مسرعا من المسبح ، واعتقدت أن الحرب وقعت ، حيث شعرنا بحالة من الهلع والرعب لشدة الصوت الذي صم آذاننا ""."	SUBJ
"وتضيف الأميوني : "" يلجأ العدو إلى استخدام هذه التكتيكات خلال الحروب لعدة أسباب منها إرهاب المواطنين ونشر الرعب والخوف بينهم ، والتأثير على معنويات المدنيين والمقاتلين وإرادتهم في المواجهة ""."	OBJ
"وتختم : "" يستخدم الإسرائيلي هذه التكتيكات اعتقادا منه أنها ميزة تخطيطية لإرباك القوات المقاتلة وتشتيت انتباهها عن العمليات العسكرية ""."	SUBJ
"رأي عسكري وقال رئيس مركز الشرق الأوسط للدراسات والعلاقات العامة الخبير العسكري العميد المتقاعد في الجيش اللبناني هشام جابر لموقع "" سكاي نيوز عربية "" ، إن "" عملية خرق جدار الصوت غير مكلفة ماديا ، وفيزيائيا تحدث عند تنفيذ عملية طيران تحت سرعة الصوت ثم رفع السرعة فجأة."	OBJ
"هذا التغيير الكبير في سرعة الطائرة يخلق تيارا في الهواء يسبب دويا قويا كالغارة الحقيقية ، وإذا نفذ على علو منخفض ممكن أن يكسر زجاج الأبنية ومن الممكن أن تنهار بعض الأبنية المتصدعة ، وهذا هو الضرر المادي ""."	OBJ
"وتابع جابر : "" أما الضرر المعنوي فهو كبير ويتمثل بخلق حالة من الرعب بين المواطنين ، ويشكل حربا نفسية ضدهم ، كما حصل اليوم ( الثلاثاء ) في بيروت ، ومصدره طائرات مقاتلة تحلق على علو منخفض ""."	OBJ
"القانون الدولي قال رئيس مؤسسة "" جوستيسيا "" في بيروت العميد في الجامعة الدولية للأعمال في ستراسبورغ البروفيسور بول مرقص ، لموقع "" سكاي نيوز عربية "" : "" لا ينظم القانون الدولي بشكل صريح كسر حاجز الصوت ، لكنه يتطرق إلى جوانب متعلقة بذلك من خلال بعض المعاهدات الدولية ""."	OBJ
"وأضاف مرقص : "" وفقا لاتفاقية شيكاغو ، تتمتع الدول بسيادة حصرية على مجالها الجوي ، مما يتطلب إذنا للطائرات لا سيما الأسرع من الصوت من قبل الدول الأخرى."	OBJ
"وتضع منظمة الطيران المدني الدولي معايير لتقليل الضوضاء والأضرار الصوتية والبيئية ، وغالبا ما تقيد الرحلات الجوية الأسرع من الصوت فوق المناطق المأهولة بالسكان بسبب دوي اختراق الصوت ""."	OBJ
"وختم : "" تضمن معايير السلامة التابعة لمنظمة الطيران المدني الدولي أن تفي الطائرات الأسرع من الصوت بمتطلبات الأداء للتشغيل الآمن."	OBJ
"كما أنه في حالة إسرائيل ، فإن دخول المجال الجوي هو خرق للسيادة اللبنانية ، حتى لو لم يؤد إلى أضرار """	OBJ
يتابع الإسرائيليون بقلق ما ينشر يوميا عن التهديد الإيراني بشن هجمات خلال الأيام ، وربما الساعات ، المقبلة ، مما دفع الكثير منهم لحجز رحلات طيران خارجية لحين استقرار الأوضاع ، في حين كان الوضع على أشده بالنسبة للمقيمين في مدينة حيفا الساحلية ، التي يتخوف سكانها من خطر التعرض لقصف مكثف قد يصل إلى مئات الصواريخ.	OBJ
ويعتقد محللون ومراقبون أن الإسرائيليين اعتادوا تكرار التعامل مع مثل هذه الأوقات الصعبة ، وبشكل خاص منذ هجوم السابع من أكتوبر ، إذ اتخذوا الكثير من الإجراءات الوقائية ببناء الملاجئ حتى داخل منازلهم ، وسافر بعضهم إلى الخارج ، لكنهم في الوقت ذاته يتخوفون من تصعيد من دون أفق لإنهائه.	SUBJ
على وقع تلك التهديدات ، اتخذت السلطات الإسرائيلية عددا من الإجراءات السريعة ، على رأسها فتح الملاجئ في عدد من مناطق البلاد ، مثل تل أبيب وشارون وروش هاعين وكريات أونو ، وإلغاء بعض الرحلات الجوية من وإلى إسرائيل.	OBJ
وذكرت وسائل إعلام إسرائيلية أن أكثر من 100 ألف إسرائيلي باتوا عالقين في الخارج ، بسبب إلغاء الرحلات الجوية إلى إسرائيل.	OBJ
"وفي إطار الإجراءات التحضيرية ، تم كذلك إجراء تمرين تدريبي في غرفة عمليات نجمة داوود الحمراء ، الخدمة الطبية الرسمية في إسرائيل ، وفق صحيفة "" معاريف "" التي ذكرت أن التحضيرات شملت تمرينا على عمليات التبرع بالدم في حالات الطوارئ."	OBJ
"وأشارت صحيفة "" تايمز أوف إسرائيل "" ، إلى أن السلطات اتخذت تدابير وقائية تحسبا لأي تصعيد محتمل ، كإخلاء المناطق الصناعية من المواد الخطرة."	OBJ
وتضم حيفا ، التي يقطنها نحو 280 ألف نسمة ، 110 ملجأ عاما بحالة جيدة ، إضافة إلى مئات الملاجئ الخاصة داخل المباني السكنية ، فمنذ أحداث 7 أكتوبر بنى العديد من السكان ملاجئ خاصة في منازلهم.	OBJ
ومع بداية الموجة الأخيرة من الصراع ، هرع الإسرائيليون لتخزين المؤن والمستلزمات وغيرها من السلع المتعلقة بالطوارئ ، ومع ذلك يبدو أن هذا التهافت على التخزين قد تراجع مؤخرا.	SUBJ
وبالموازاة ، أعلنت قيادة الجبهة الداخلية للجيش الإسرائيلي استكمال التجارب على نظام جديد لإرسال رسائل تحذير عامة قائمة على تحديد المواقع ، الذي يعتمد على تقنية البث الخلوي ، وهي طريقة لإرسال رسائل قصيرة إلى مستخدمين متعددين للهواتف في منطقة محددة.	OBJ
أخبار ذات صلة إحاطة مهمة من فريق الأمن القومي لبايدن وهارس.	SUBJ
"صحيفة : هناك إشارات على أن إيران تستعد لهجوم على إسرائيل ترقب حذر يقول المحلل السياسي الإسرائيلي شلومو غانور إن المجتمع الإسرائيلي "" يعيش حالة من الترقب واليقظة ، لكنه يواصل حياته شبه العادية معتمدا على الثقة أنه في حال تغير الأوضاع ستصدر قيادة الجبهة الداخلية التعليمات الموثوقة بالنسبة للتدابير اللازم اتخاذها ""."	OBJ
"وأضاف غانور لموقع "" سكاي نيوز عربية "" ، أن "" المواطن العادي يثق بقدرات الجيش الإسرائيلي ، حتى إن هناك تزايدا للأصوات المطالبة بتوجيه ضربة استباقية ، وعدم إطالة فترة الانتظار التي قد ترهق الأعصاب وتعطل البرامج الشخصية وتقضي على ما تبقى من موسم الصيف للرحلات والاستجمام ""."	OBJ
"وشدد على أن "" الإسرائيلي غير مستعد لتغيير برامجه الشخصية لفترة الصيف ، مهما كانت الأوضاع الأمنية أو الاقتصادية في البلاد ، وهذا ما ثبت في الحروب وحالات التوتر الأمنية السابقة التي عادة ما تقع في أشهر الصيف ""."	OBJ
"وعن رحلات السفر للخارج ، قال غانور إن "" الملاحظ ضغط الإسرائيليين الذين غادروا قبل التوتر الحالي والمتواجدين في الخارج ، على الحكومة لتأمين إمكانية العودة بسرعة إلى إسرائيل ، بعد قرارات شركات الطيران الأجنبية تعليق رحلاتها ""."	OBJ
"وعن رأي الشارع الإسرائيلي تجاه استعدادات المؤسسات الأمنية ، قال المحلل السياسي إن "" القوات الإسرائيلية حسب التقارير الرسمية والمطلعين ، أكملت استعدادات لمواجهة أي هجوم من إيران أو حزب الله ، سواء كان منفردا أو جماعيا ""."	OBJ
"أخبار ذات صلة الضربة الإيرانية الوشيكة "" تقلق طهران ""."	SUBJ
"واشنطن وباريس تدعوان إلى "" أقصى درجات ضبط النفس "" في المنطقة تخوفات."	SUBJ
"وغياب استراتيجية الحكومة بصورة أكثر عمقا للمشهد من الداخل الإسرائيلي ، قال المحلل السياسي الإسرائيلي يوآب شتيرن لموقع "" سكاي نيوز عربية "" ، إن "" هناك حالة تأهب وترقب بالداخل الإسرائيلي ، وهناك من يخشى تداعيات الحرب وما ستؤول إليه الأمور ""."	OBJ
"وأضاف : "" دائما ما نرى مثل هذه الأمور في الحروب ، لكن ما يختلف في إسرائيل أن هذا ليس مخفيا."	SUBJ
واعتبر شتيرن أن ارتفاع معدل السفر للخارج يرتبط بالتخوفات الكبيرة من التصعيد غير المحسوب ، وفي مثل هذه الحالات تغادر بعض العائلات إسرائيل سواء إلى أوروبا أو الولايات المتحدة ، ومنهم من يبقى لمدة طويلة ، أما الباقي فسرعان ما يعودون لديارهم.	OBJ
"لكن رغم اعتقاد المحلل الإسرائيلي أن الجيش قام بما يلزم للتصدي للهجوم المحتمل من إيران ، فقد أكد أن "" المشكلة الأكبر تتمثل في غياب استراتيجية سياسية من جانب الحكومة ""."	SUBJ
حشدت الولايات المتحدة قوات لها بالشرق الأوسط في ظل زيادة التوتر بين إيران ووكلائها من جهة وإسرائيل من جهة أخرى ، على خلفية اغتيال رئيس المكتب السياسي لحركة حماس اسماعيل هنية في طهران ، وفؤاد شكر القيادي في حزب الله في غارة إسرائيلية على الضاحية الجنوبية ببيروت.	OBJ
"صحيفة "" نيويورك تايمز "" نقلت عن مسؤول عسكري أميركي قوله إن "" القوات الأميركية في الشرق الأوسط تتخذ "" الإجراءات الضرورية لزيادة الاستعداد القتالي وحماية قواتها وحلفائها من أي تهديدات من جانب إيران أو الميليشيات المدعومة منها ""."	OBJ
"بينما كشفت صحيفة "" واشنطن بوست "" عن نشر الولايات المتحدة 12 سفينة حربية في مناطق متفرقة بالشرق الأوسط تشمل حاملة الطائرات "" يو إس إس ثيودور روزفلت "" والسفن الحربية المرافقة لها ومجموعة "" واسب "" البرمائية الجاهزة ، وهي قوة مهام برمائية مكونة من 3 سفن تضم أكثر من 4000 من مشاة البحرية والبحارة."	OBJ
"ويرى خبراء ومحللون أميركيون تحدثوا لموقع "" سكاي نيوز عربية "" ، أن الإجراءات التي تتخذها واشنطن تهدف إلى منع التصعيد وعدم خروج الأمور عن السيطرة والدفاع عن حماية المصالح الأميركية بالمنطقة ، والتعامل مع الرد الإيراني المرتقب."	OBJ
"نتنياهو : وجهنا ضربات على 3 جبهات خلال الأيام الماضية منع التصعيد الخبير الأميركي ريتشارد وايتز ، مدير مركز التحليل السياسي العسكري في معهد هدسون ، قال في تصريحات خاصة لموقع "" سكاي نيوز عربية "" ، إن التحركات العسكرية الأميركية من شأنها أن تساعد في منع التصعيد الذي لا تريده الولايات المتحدة."	OBJ
"ويرى "" وايتز "" إن إدارة الرئيس الأميركي جو بايدن مقتنعة بأن إيران ستهاجم إسرائيل في غضون أيام ، وذلك وفق ما أفادت به مكالمة بين الرئيس الأميركي جو بايدن ورئيس الوزراء الإسرائيلي بنيامين نتنياهو."	OBJ
"ووفق ما جاء في المكالمة التي نشر تفاصيلها موقع "" أكسيوس "" الأميركي ، فإن "" بايدن أكد التزامه بأمن إسرائيل ضد كل التهديدات التي تمثلها إيران ، بما في ذلك وكلاؤها حماس وحزب الله والحوثيين ""."	OBJ
كما ناقش بايدن دعم إسرائيل ضد إطلاق الصواريخ الباليستية والطائرات من دون طيار ، لتشمل نشر قوات عسكرية أميركية دفاعية جديدة ، مع التأكيد على ضرورة خفض التصعيد في المنطقة.	OBJ
ووفق مدير مركز التحليل السياسي العسكري في معهد هدسون ، فإن واشنطن تحاول في الوقت نفسه تغيير رأي إيران أو على الأقل مساعدة إسرائيل في الدفاع عن نفسها ضد هجوم إيراني كبير آخر.	OBJ
وحسب تسوكرمان ، فإن الرد المرتقب قد يتضمن هجمات مباشرة أو غير مباشرة على المواقع العسكرية الأميركية الموجودة في المنطقة ، وعلى سبيل المثال ، هناك شائعات حول الضربة الإيرانية المخطط لها بطائرات من دون طيار ضد إسرائيل.	OBJ
وأضاف أنه إذا اتبعت إيران نمط الهجوم الذي نفذته في أبريل ، فقد تكلف إسرائيل وحدها أكثر من مليار دولار للدفاع فقط ، كما ستؤدي أيضا إلى تكاليف إضافية للولايات المتحدة والدول المجاورة ، فضلا عن تكاليف إغلاق المجال الجوي لمنع استهداف حركة الطيران التجاري.	OBJ
وترى الباحثة الأميركية أن السيناريوهات المحتملة الأخرى تتضمن ضربات بعيدة المدى من قبل الحوثيين داخل إسرائيل ، والتي تنطوي على فرصة لإلحاق الضرر بمناطق أخرى ذات مصالح دولية مثل الموانئ الإسرائيلية ، أو القوات البحرية والسفن التجارية القريبة.	OBJ
"وتعتقد تسوكرمان أنه في ظل هذه التهديدات فإن "" زيادة قدرات الردع خطوة معقولة ، أولا لإظهار جدية اهتمام واشنطن بالحفاظ على الأمن والاستقرار ، وثانيا للتنسيق اللوجستي مع الحلفاء الإقليميين لمنع تكاليف الدفاع من الارتفاع الشديد ، وثالثا لتجنب التصعيد ومنع إيران ووكلائها من اتخاذ إجراءات تتجاوز الضربات الرمزية التي قد تؤدي إلى خسائر مدنية أو عسكرية كبيرة ثم تؤدي إلى صراع أطول أمدا ""."	OBJ
"كما تفترض أن "" إيران ووكلاءها قد يحاولون جر إسرائيل إلى نمط من القتال يجعلها تحتاج موافقة الولايات المتحدة للرد ، وهذا سبب آخر للاحتفاظ بالمقاتلات الأميركية وأشكال أخرى من الاستعداد العسكري ، فقد تحاول إيران إلحاق الضرر بإسرائيل من خلال الأطراف والمناطق التي لا تستطيع تل أبيب مهاجمتها بسهولة بمفردها ، وعلاوة على ذلك استخدام هذه المناطق كملاذ لبعض وكلائها في حالة خروج خططهم عن نطاق السيطرة ""."	OBJ
"أثار تغيير حزب الله اللبناني لاستراتيجيته في التعامل مع إسرائيل ، من كونه عنصرا بارزا في "" جبهة الإسناد "" لحرب غزة استنادا لمفهوم "" وحدة الساحات لمحور المقاومة "" ، إلى الدخول في مرحلة "" المعركة الكبرى "" المستقلة ، تساؤلات بشأن تداعيات ذلك على الأرض ، وما تحمله الأيام المقبلة لمسار التصعيد المشتعل في المنطقة ، الذي رفع سقف الخوف من الانزلاق لحرب إقليمية كبرى إلى ذروته."	OBJ
"هذه الاستراتيجية الجديدة لحزب الله عبر عنها صراحة الأمين العام للجماعة اللبنانية حسن نصر الله في خطابه ، الخميس ، حين قال إن "" المعركة مع إسرائيل قد دخلت مرحلة جديدة "" ، مفسرا ذلك بأننا "" أمام معركة كبرى تجاوزت فيها المسألة جبهات الإسناد ""."	OBJ
أما ما أثار هذا التحول الاستراتيجي لحزب الله والمواجهة برمتها في المنطقة ، فهو مقتل شكر بعد غارة إسرائيلية استهدفته في الضاحية الجنوبية لبيروت ، وبعدها بأقل من 24 ساعة اغتيال رئيس المكتب السياسي لحماس إسماعيل هنية داخل مقر إقامته في طهران.	OBJ
"في المقابل ، ردت إسرائيل على تهديد حزب الله بالتأكيد على قدرتها على "" التعامل مع التهديدات دفاعيا والرد بقوة في هجوميا "" ، وفقما قال المتحدث باسم الجيش دانيل هغاري."	OBJ
"أخبار ذات صلة "" تيشاع بآف ""."	SUBJ
لماذا قد تختار إيران أهم يوم للرد على إسرائيل ؟	SUBJ
"هواتف "" خاصة "" لوزراء إسرائيل كيف سيكون شكل المعركة ؟"	SUBJ
"قال منسق الحكومة اللبنانية السابق لدى قوات الطوارئ الدولية العميد منير شحادة ، إن المواجهة بين حزب الله وإسرائيل منذ السابع من أكتوبر كانت ضمن "" قواعد الاشتباك "" على الحدود ، بعمق 5 إلى 7 كم من الجهتين."	OBJ
"لكن ما تجاوز هذه القواعد قيام إسرائيل باغتيال القيادي في حماس صالح العاروري بقلب الضاحية الجنوبية قبل أشهر ، مما نقل القتال لمرحلة "" قواعد الردع "" وفق شحادة ، الذي أضاف أنه "" جرى اختراق قواعد الاشتباك من قبل إسرائيل بتجاوزها إلى داخل معقل حزب الله ، مما دفع الحزب إلى تغيير استراتيجية وقصف قاعدة ميرون الاستراتيجية "" ، على بعد 8."	OBJ
5 كيلومترات من الحدود اللبنانية.	SUBJ
"وأوضح شحادة لموقع "" سكاي نيوز عربية "" ، أنه بعد اغتيال العاروري بداية العام الجاري ثم قصف القاعدة الإسرائيلية ، حدث توازن جديد لقواعد الردع ، وظلت الحالة مستمرة بين الجانبين ، حتى حدث اختراق جديد باغتيال شكر ، ليعلن بعدها نصر الله الانتقال إلى مرحلة "" المعركة الكبرى ""."	OBJ
"وبشأن ما تعنيه مرحلة "" المعركة الكبرى "" المفتوحة ، أوضح أنها تتمثل في تغيير محور المقاومة بأكمله لاستراتيجيته بالانتقال لمرحلة أكثر قوة في المواجهة مع إسرائيل ، وسيكون ذلك عبر حدثين مهمين متوقعين في الأيام المقبلة ، أولهما رد حزب الله على اغتيال شكر ، وثانيهما رد إيران على اغتيال هنية ، باعتبار أن ذلك حدث في طهران."	OBJ
"وأضاف : "" الرد قد يكون متناسقا ومتزامنا في توقيت واحد ، لإعطاء تأثير أكبر على إسرائيل ، أو منفصلا وعلى فترات ""."	SUBJ
"لكن في كلا الحالتين ، أشار شحادة إلى أن "" حجم الرد من المقاومة سيكون غير مسبوق ، لم يحدث منذ بداية المعركة وحتى اليوم "" ، انتظارا لرد فعل إسرائيل التي "" إن ردت بعنف فإن ذلك يعني الدخول في مرحلة الرد والرد المضاد ، ثم قد تنزلق الأمور إلى حرب شاملة من دون أسقف تتجاوز كافة الخطوط الحمراء "" ماذا سيحدث في حال استهداف حقول الغاز الإسرائيلية ؟"	OBJ
"هل أدت "" جبهة الإسناد "" دورها ؟"	SUBJ
"في رأي مدير المنتدى الإقليمي للدراسات والمحلل العسكري اللبناني العميد خالد حمادة ، فإن جبهة حزب الله "" لم تكن لإسناد غزة ، بل استراتيجية إيرانية لإبقاء طهران في المشهد الإقليمي بعد الموقف الذي اتخذته من التنصل من علاقتها بعملية طوفان الأقصى ، وبالتالي حاولت أن تحافظ على هذه الاشتباكات لكي تبقي نفسها كأحد اللاعبين المؤثرين في المشهد مما يجعلها شريكة في أي تفاوض مستقبلي ""."	OBJ
"وأوضح حمادة لموقع "" سكاي نيوز عربية "" ، أن "" المعركة التي اندلعت انطلاقا من الجنوب اللبناني لم تتمكن من تخفيف الضغط على غزة ، ولم تدفع إسرائيل إلى تغيير استراتيجيتها ، بل على العكس ازدادت عدوانية إسرائيل ودمرت قطاع غزة بأكمله ""."	OBJ
"وفي خضم التحول إلى مرحلة جديدة ضمن "" المعركة الكبرى "" ، قال الخبير العسكري إن "" حزب الله ولبنان برمته سيكون عرضة لظروف صعبة وحرجة في معرض الرد والرد المضاد ، لأن التسويات المقبلة بالمنطقة لا يمكن أن تتم بدم بارد ، بل قد تكون بحرب أشد مما كنا نتوقعه ""."	OBJ
"وأشار إلى أن هذه المرحلة الجديدة تعني أن الجنوب اللبناني سيكون أكثر عرضة لاعتداءات إسرائيلية متكررة حال اتخذت طهران قرارا بالرد بقوتها الذاتية أو بتكليف الأذرع ، مضيفا : "" الحرب ستكون مفتوحة بلا أي رادع ، وهذا ما كان يجب أن يدركه نصر الله قبل بدء معركة الإسناد ذاتها ""."	OBJ
"ولفت حمادة إلى أن رد حزب الله وإيران على اغتيال شكر وهنية "" بات متوقعا "" ، لكن في المقابل فالولايات المتحدة تضع أمن إسرائيل فوق كل اعتبار ، وستعمل على دعمها عسكريا وسياسيا في هذه المرحلة."	OBJ
وأكد مدير السجون في مؤتمر صحفي أن إدارة سجن كوبر هي من سمحت بإخراج عناصر النظام السابق بعد أوامر من رئيس القضاء.	SUBJ
80 % Fullscreen وبعد الإطاحة بحكمهم الذي استمر 30 عاما ، في أبريل 2019 ، اعتقل عدد من عناصر تنظيم الإخوان من المشاركين في الانقلاب الذي نفذه البشير في العام 1989.	OBJ
وإضافة إلى تهمة انقلاب 1989 التي تصل عقوبتها للإعدام ، يواجه البشير وعدد من عناصر النظام السابق المطلق سراحهم ، تهما أمام المحكمة الجنائية الدولية بارتكاب جرائم ضد الإنسانية خلال حرب دارفور التي اندلعت في العام 2003 واستمرت نحو 17 عاما ، وشهدت أعمال قتل واغتصاب وحرق ونزوح ولجوء طالت أكثر من مليوني شخص.	OBJ
أخبار ذات صلة مراقبون يحددون 3 خطوات لحل أزمة السودان هؤلاء الزعماء مطلوبون للجنائية الدولية.	SUBJ
لكنهم مازالوا طلقاء حسم الجدل لفترة طويلة ظل طرفا القتال في السودان يتبادلان الاتهامات حول مسؤولية إطلاق سراح السجناء.	SUBJ
لكن مدير السجون قال في مؤتمر صحفي إن خروج عناصر النظام السابق من سجن كوبر تم تحت إشرافه وبعد توقيعهم على تعهدات بناء على أوامر من نائب رئيس القضاء بعد اتصال جرى معه.	OBJ
ووفقا له ، فإن السجن كان يتعرض لضربات مستمرة أثارت مخاوف على حياة السجناء ، مشيرا إلى أن عدد سجناء النظام السابق كان 18 سجينا في وضع الانتظار وكان بعضهم يتلقى العلاج في أحد المستشفيات.	OBJ
"ورأى مدير السجون أن إجراء إخراجهم بعد كتابة تعهدات كان صحيحا نظرا لأن قضيتهم قضية "" راي عام ""."	SUBJ
لكن المعز حضرة عضو هيئة الاتهام في قضية انقلاب 1989 والتي كان يحاكم فيها البشير وأعوانه المنتظرين في سجن كوبر ، قال لموقع سكاي نيوز عربية إن السجناء المطلق سراحهم كانوا يحاكمون في قضية جنائية تتعلق بواحدة من أخطر الجرائم المنصوص عليها في القانون السوداني.	OBJ
"وأضاف "" حديث مدير السجون يؤكد ما قالته هيئة الاتهام في بيان سابق بأن إدارة سجن كوبر هي من أخرجت عناصر النظام السابق المطلوبين في قضايا جنائية تتعلق بتقويض الدستور وتهم أخرى خطيرة ""."	OBJ
"وأوضح "" أخطر ما ورد في حديث مدير السجون هو أن المطلق سراحهم كانوا سجناء سياسيين وسجناء رأي عام ، في حين إنهم كانوا يحاكمون في قضايا خطيرة تتعلق بجرائم موجهة ضد الدولة (."	OBJ
) كان يمكن نقلهم إلى مكان آمن تحت حماية الجيش (.	SUBJ
") هذه جرائم لا يجوز إطلاق سراح المنتظرين فيها بتعهد او ضمان ""."	SUBJ
لغز مستمر في حين حسمت تصريحات مدير السجون الجدل حول الجهة التي أطلقت سراح عناصر نظام البشير من سجن كوبر ، إلا أنها لم تكشف عن اللغز الذي ظل يحير السودانيين حول مكان وجود البشير وأعوانه.	OBJ
وبالتزامن مع إطلاق سراح عناصر النظام السابق من سجن كوبر ، أشارت تقارير إلى أن قوة عسكرية اقتحمت سجن الهدى في أم درمان وأخذت معها 28 من ضباط جهاز الأمن الذين كانوا ينتظرون تنفيذ حكم الإعدام في جريمة قتل المعلم أحمد الخير داخل معتقله خلال الحراك الذي أطاح بنظام حكم الإخوان.	OBJ
ومنذ خروج المطلوبين من عناصر النظام السابق من سجن كوبر ، ظل السودانيون يتساءلون عن مكان وجودهم ، لكن تقارير أشارت إلى أن بعضهم كان يتحرك بحرية في عدد من مناطق البلاد ، حيث كشف أحد قادة تنظيم الإخوان في مقطع فيديو موثق عن لقاء أجراه معهم أحمد هارون في منطقة الجزيرة بعد أشهر من اندلاع الحرب بهدف وضع خطط للتحشيد الشعبي.	OBJ
أخبار ذات صلة اتهام دول وتجاهل أخرى.	SUBJ
"السودان ساحة للشائعات "" الغربية "" لماذا يعارض "" الإخوان "" جهود وقف الحرب السودانية ؟"	SUBJ
اما بالنسبة للبشير ، فقد تضاربت الأنباء عن مكان وجوده ، في حين أشارت تقارير غير مؤكدة إلى نقله إلى خارج البلاد بطائرة أقلته من داخل مستشفى تابع للجيش في أم درمان كان يتلقى فيه العلاج عند اندلاع القتال.	OBJ
"وكان قائد الجيش عبد الفتاح البرهان ألمح في تصريحات صحفية عن وجوده في "" مكان آمن "" دون ان يحدد ذلك المكان."	OBJ
ويعتقد الكثير من المراقبين أن أنصار البشير عملوا على تهريبه مستغلين حالة الفوضى العارمة التي تعيشها الخرطوم.	SUBJ
"وفي هذا السياق ، يقول حضرة "" حالة الغموض الحالية التي تحيط بمكان البشير تعزز الاعتقاد بتهريبه إلى خارج البلاد."	SUBJ
"ويوضح "" كل شيء ممكن (."	SUBJ
) كانت هنالك جهات عديدة تعمل على إجهاض محاكمته (.	SUBJ
") نحن كهيئة اتهام لا نعرف شيئا عن مكان وجوده ""."	SUBJ
وكانت الدائرة التمهيدية بالمحكمة الجنائية الدولية قد أصدرت في العام 2009 ، مذكرة توقيف بحق البشير وعدد من معاونيه ، بناء على اتهامات بجرائم ضد الإنسانية وجرائم حرب دارفور.	OBJ
مزيد من الشكوك في خضم التقارير التي تحدثت عن صعوبات كبيرة تواجهها المحكمة الجنائية في معرفة مكان البشير والمطلوبين الآخرين ، شكك مراقبون في خطاب مسرب قبل نحو ثلاث أسابيع ، منسوب لإحدى السلطات الولائية تقول فيه أن الظروف الأمنية الحالية دفعتها للإفراج عن جميع المسجونين.	OBJ
ورأى مراقبون أن التسريب يأتي ضمن خطة تهدف لإجهاض المطالب الرامية لإعادة اعتقال المطلوبين من عناصر النظام السابق.	OBJ
ونبه مراقبون إلى تزامن تسريب الخطاب مع الضغوط الجارية حاليا للعودة إلى منبر جدة وتنفيذ بنود بناء الثقة التي تم الاتفاق عليها ومن بينها إعادة القبض على المطلوبين للمحكمة الجنائية وعناصر النظام السابق المطلوبين في قضايا أخرى ومن بينهم نافع على نافع وعلي عثمان محمد طه وآخرين تضارب الأنباء بشأن مصير الرئيس السوداني عمر البشير وأشاروا إلى احتمالين ، إما ان يكون الخطاب المسرب غير حقيقي وصادر عن غرف الإخوان الإعلامية أو حقيقي وفي الحالتين يقصد به تبرير اختفاء المطلوبين وبالتالي اجهاض البند الخاص بإعادة اعتقالهم.	OBJ
وكانت اتفاقيات أبرمت بين الجيش وقوات الدعم السريع في جولتي تفاوض جرت بوساطة دولية في جدة والمنامة قد نصت بوضوح على القبض على الفارين من السجون وتسليم المطلوبين لدى الجنائية للعدالة الدولية ، لكن هذا البند لم ينفذ حتى الآن.	OBJ
وواجه وفد المحكمة الجنائية الدولية الذي زار بورتسودان خلال الأسبوع الثاني من مارس ، صعوبات كبيرة في الحصول على معلومات حقيقية عن مكان تواجد المطلوبين لديها من المتهمين بارتكاب جرائم في دارفور وعلى رأسهم البشير ومساعديه عبد الرحيم محمد حسين وأحمد هارون.	OBJ
"وفي حين نقلت وكالة السودان للأنباء عن وزيرة العدل المكلفة هويدا عوض الكريم ، القول بأن الدعم السريع عطل الأجهزة المكلفة بالقبض على المطلوبين للجنائية ، أكد محامون سودانيون لموقع "" سكاي نيوز عربية "" أن المدعي العام للمحكمة الجنائية كريم خان أبلغهم أنه على علم بأن المطلوبين يتمتعون بالحماية."	OBJ
كيف يمكن لبريطانيا استعادة سمعتها العالمية ؟	SUBJ
"سكاي نيوز عربية - أبوظبي 12 : 40 - 29 يوليو 2024 لندن - بريطانيا - اقتصاد "" إعادة الاتصال بالحلفاء "" و "" الوقوف بقوة مرة أخرى على المسرح العالمي ""."	OBJ
"ستارمر بصفته رئيسا للوزراء ، قال للزعماء الأوروبيين المجتمعين في قصر بلاينهايم الأسبوع الماضي ، إنه "" سيعيد ضبط "" نهج بريطانيا والالتزام بالمشاركة العالمية القائمة على "" الإنسانية والاحترام العميق للقانون الدولي ""."	OBJ
"وخلال حفل أداء وزيرة العدل الجديدة شابانا محمود للقسم ، وصفت سيادة القانون بأنها "" القيم البريطانية الأكثر ديمومة "" ، وبعد بضعة أيام ، تحدث الملك تشارلز الثالث في خطاب الملك عن التزام حكومته "" بالقيم المشتركة المتمثلة في الحريات الفردية والديمقراطية وحقوق الإنسان وسيادة القانون ""."	OBJ
خاصة وأن تغيير اللهجة هو الجزء السهل ، وأن إعادة الانضمام إلى الهيئات الدولية أو تعديل جوانب المعاهدات مع الاتحاد الأوروبي ، واضحة ومباشرة ، ومع ذلك ، فإن ما تحتاجه المملكة هو شيء أكثر جوهرية.	SUBJ
وأكد أن ستارمر يتمتع بخبرة فعلية في التعامل مع العالم ، أكثر من أي رئيس وزراء بريطاني حديث آخر ، وأنه ذو خلفية تترسخ لديها مبادىء عديدة من بينها أن الاتفاقيات مهمة ، وأن بريطانيا زعيمة عالمية.	SUBJ
التصويت لصالح الخروج من الاتحاد الأوروبي - على أساس رؤية للعظمة العالمية – أضر بسمعة بريطانيا.	SUBJ
وتذكر ما شاهده بنفسه مما أطلق عليه نكسات بريطانية كبرى في صيف العام 2017 في الجمعية العامة للأمم المتحدة ، وبصفته محاميا لموريشيوس ، كان قد لاحظ أن أغلبية كبيرة من البلدان صوتت لصالح طلب رأي استشاري من محكمة العدل الدولية بشأن الإرث الاستعماري البريطاني ، وتقطيع أوصال أراضي موريشيوس في العام 1965 ، وإنشاء مستعمرة جديدة ( المعروفة باسم الإقليم البريطاني في المحيط الهندي ) والترحيل القسري لكامل سكان تشاغوس.	OBJ
"كان القضاة البريطانيون الذين يتعاملون مع القضايا الأوروبية يطلق عليهم وصف "" أعداء الشعب ""."	SUBJ
وأضاف أنه لم يمض وقت طويل بعد توقيع بروتوكول أيرلندا الشمالية مع الاتحاد الأوروبي ، وهو اتفاق دولي ملزم ، حتى هددت الحكومة بتمزيقه ، وبالنسبة لبلد بنيت تجارته وسمعته على احترام مفترض للاتفاقيات الدولية ، كانت مثل هذه التصرفات متهورة ومدمرة ، مما عزز الرأي القائل بأن قادته أصبحوا منفصلين بشكل متزايد عن حقائق الوضع.	OBJ
وفي قضية ثالثة ، قدمت بريطانيا قضية تتعلق بعمل منظمة العمل الدولية ، لا تقولوا إن هناك حق في الإضراب بموجب القانون الدولي.	SUBJ
وأكد ساندز أن مثل هذه الحجج ترسل إشارات تلتقطها بلدان أخرى ، الأمر الذي يعزز الشعور بأن بريطانيا أصبحت شبه منفصلة عن النظام القائم على القواعد الذي ساعدت في خلقه (.	SUBJ
وأشار إلى أن الحكومة البريطانية الجديدة بدأت في الالتزام بالقواعد الدولية ، من خلال بعض الخطوات ، منها : انتهاء سياسة الترحيل لرواندا.	SUBJ
إسقاط الجهود الرامية إلى تأخير إصدار المحكمة الجنائية الدولية للوائح الاتهام في الصراع الحالي بين إسرائيل وحماس.	OBJ
تمويل وكالة الأمم المتحدة لإغاثة وتشغيل اللاجئين الفلسطينيين ( الأونروا ) مرة أخرى.	OBJ
هناك حديث نشط عن إبرام اتفاقية دفاعية وأمنية مع الاتحاد الأوروبي.	SUBJ
وفي ظل السباق المحموم الذي تخوضه الدول فيما بينها ، لتطوير برامج وتقنيات الذكاء الاصطناعي التوليدي ومحاولة كل طرف من الأطراف حجز موقع متقدم له في هذه الصناعة ، تسعى الصين لتعزيز موقفها في هذا المشهد الحيوي للابتكار التكنولوجي.	OBJ
وتعمل الصين على ذلك من خلال استثمارات كبيرة تقوم بها في مجالات البحث والتطوير ، ما يمنحها القدرة على إنتاج نماذج متقدمة ، من برامج وتقنيات الذكاء الاصطناعي التوليدي ، قادرة على التفاعل بطريقة ذكية مع البيانات والأنظمة المعقدة.	OBJ
حيث تشدد بكين على ضرورة أن تكون روبوتات الدردشة العاملة في البلاد ، متناسبة من حيث أجوبتها مع التوجهات السياسية العامة التي تضعها الحكومة الصينية ، بما يضمن استخدامها بطرق تعزز الفائدة العامة وتقلل المخاطر السلبية.	OBJ
"وبحسب تقرير أعدته صحيفة "" فاينانشال تايمز "" وإطلع عليه موقع "" اقتصاد سكاي نيوز عربية "" ، فإن النماذج اللغوية الكبيرة التي تنتجها شركات الذكاء الاصطناعي في الصين يتم اخضاعها لمراجعة حكومية ، للتأكد من أن ردودها على المواضيع الحساسة ، تجسد القيم الاشتراكية الأساسية للبلاد ، إذ تتم هذه المراجعة من قبل إدارة الفضاء الإلكتروني في الصين ( CAC ) وهي الجهة المنظمة للإنترنت في البلاد."	OBJ
"وتتم "" التصفية الأمنية "" عن طريق إزالة "" المعلومات الإشكالية "" الموجودة ضمن البيانات التي يتم تدريب روبوتات الدردشة عليها ، ليصار بعدها إلى إنشاء قاعدة بيانات بالكلمات والعبارات الحساسة التي يجب تجنب استخدامها ، بما يضمن عدم توليد الروبوتات لمحتوى "" غير قانوني ""."	OBJ
والشروط التي تضعها إدارة الفضاء الإلكتروني في الصين ( CAC ) تشمل جميع اللاعبين الأساسيين في تطوير هذه التكنولوجيا ، من عمالقة التكنولوجيا مثل ByteDance وAlibaba إلى الشركات الناشئة الصغيرة.	OBJ
أصبحت أمام ترامب فسحة كبيرة يستطيع بعدها أن يشير إلى ما سوف يفعله فى السلطة لتغيير أمريكا ومن ورائها العالم.	SUBJ
وفى الخارج كانت المقترحات الصادمة التى تذهل المستمعين حتى تزيغ فى عيونهم الحقيقة وعما إذا كانت قابلة للتنفيذ ؛ أو أنها محض هزل لمعتاد عليه.	SUBJ
مقترحات ترامب لضم كندا واسترجاع قناة بنما ، وتغيير اسم « خليج المكسيك » إلى « خليج أمريكا » ثم شراء أو ضم « جرينلاند » كانت مدهشة للعالم الذى لم يكن على استعداد لتخيل أن تكون أكثر من رئيس لا يتوقف عن الدعاية لنفسه.	OBJ
بعد تكرار حديث ترامب عما سبق وقبل أيام قليلة من دخول البيت الأبيض فإن سلسلة من التفاصيل ربما تحول الدهشة إلى ذعر ، خاصة من حلفاء أمريكا وأصدقائها.	SUBJ
المشكلة الكبرى والأقدم تتواجد مع أوروبا أو الاتحاد الأوروبى ، أو باختصار دول حلف الأطلنطى ، حيث الحلفاء والأصدقاء منذ الحرب العالمية الثانية ، وعبر الحرب الباردة ، وما بعدها من عولمة ، حيث بات على الولايات المتحدة أن تدفع عواقب تحرير التجارة الدولية ، التى أدخلت الصين وروسيا إلى معادلات مرهقة خرجت فيها الصناعات الأمريكية إلى الشرق الآسيوى ؛ بينما أدخلت واشنطن فى عداء غير ضرورى مع موسكو.	OBJ
الصورة لم تكتمل بعد ، والشيطان يكمن فى التفاصيل ، ولكن اللافت للنظر أن ما يقوله ترامب غير طالب لعدسات التصوير ، هو فى حقيقته ثورة كبرى على النظام الدولى الذى قام بعد الحرب العالمية الثانية وتكرس بعد نهاية الحرب الباردة.	SUBJ
فى هذا لم يتردد فى الإجابة عن سؤال استخدام القدرة العسكرية الأمريكية بالإيجاب ؛ إما القدرة الاقتصادية بسد الطرق نحو الأسواق الأمريكية ، أو استخدام سلاح الرسوم والجمارك ، أو إطلاق طاقات التكنولوجيا الأمريكية المتفوقة فوق الجميع فى استخدام الذكاء الاصطناعى وما يتبعه من تكنولوجيات.	OBJ
حتى وقت الكتابة ، فإن رد الفعل على ما ذكره ترامب لم يكن فيه ما يشير إلى الكيفية التى سوف ترد بها الدول على « أجندة » ترامب ومطالبه.	SUBJ
الانطباع هو أن أوروبا تعتقد أن ترامب يعيش داخل الحملة الانتخابية بخطبها وألوانها.	SUBJ
البداية هى أوروبا والهدف الانتقال بما فيها من أحزاب يمينية متطرفة من الشارع السياسى إلى سدة الحكم.	SUBJ
الانتخابات الألمانية فى الشهر القادم ، وقوة الدفع ستستمر ؛ وفى وقت الفراغ دفع قوى يمينية جديدة لكى تطيح بالحكومة العمالية البريطانية ورئيس وزرائها « كير ستامر »!	OBJ
غدا سوف يصل دونالد ترامب إلى البيت الأبيض لتبدأ حلقة جديدة من تاريخ العالم.	SUBJ
الحلقة السابقة بدأت فى 7 أكتوبر 2023 عندما قامت حماس بهجمة عسكرية ماهرة على غلاف غزة أدت إلى مقتل 1200 إسرائيلى وفقا للحديث الذائع ، و1134 وفقا للحقيقة ؛ ومعهم احتجاز 250 « رهينة ».	OBJ
وقتها اعتبرت إسرائيل ذلك أكبر جريمة إزاء اليهود منذ المحرقة النازية ؛ وساندها العالم الغربي.	SUBJ
وجهة النظر العربية كانت فى ناحية تشعر بفرحة كبيرة ، لأن الغضب الفلسطينى انفجر أخيرا بعد احتلال طال ، واضطهاد استدام ، وحقوق فلسطينية تضيع.	SUBJ
ومن ناحية أخرى أنه أما وقد عادت القضية الفلسطينية إلى الساحة الدولية مرة أخرى ، فإنها فرصة كبيرة للمضى قدما فى طريق السلام.	SUBJ
كان ذلك ما أكده بيان الدول التسع العربية - دول الخليج الست ومصر والأردن والمغرب - فى 21 أكتوبر 2023 رافضا الاعتداء على المدنيين من قبل الطرفين ؛ وطالب بمنهج له ثلاث مراحل للوصول إلى السلام.	OBJ
من جانب إسرائيل فإنها بدأت أكبر عملية هجومية على الشعب الفلسطينى نتج عنها قرابة 47 ألف ضحية ؛ وأكثر من ضعفهم جرحى ، 70 % منهم من النساء والأطفال ، مع عودة كامل قطاع غزة إلى العصر الحجري.	OBJ
القصة بعد ذلك معروفة ، وهى اصطفاف الغرب حول إسرائيل حتى بعد أن تغير موقف جماهيره ؛ واصطفاف النخب العربية وراء ما اسموه « نخب الغضب » التى دخلت الحرب من سبع اتجاهات من غزة والضفة الغربية ولبنان وسوريا والعراق واليمن وإيران.	OBJ
بعد خمسة عشر شهرا كانت نخب الغضب جميعها قد تراجعت مواقفها وقدراتها ؛ ولم تكن تعرف قبلا توازن القوى.	SUBJ
قناة الجزيرة حرصت على إعلان النصر القريب قبل أن يأتي ؛ ولم يكن مفهوما أبدا لماذا تعيش النصر بينما تطالب بوقف إطلاق النار.	SUBJ
وباختصار كان ثمن الغضب فادحا بعد أن جرى استنفاذه بإلقاء اللوم على المجتمع الدولي ، والولايات المتحدة والغرب ، وكأنه كان متصورا فى الخيال أنه سوف يكون لهم موقف معاكس!	SUBJ
وقد يقول البعض حتى إنها وهمية.	SUBJ
في الفترة التي سبقت انتخابات نوفمبر 2020 ، أصدرت حملة بايدن وثيقة بعنوان « جو بايدن والمجتمع العربي الأميركي : خطة للشراكة ».	SUBJ
كان هناك العديد من الوعود التي قدمت في صفحاتها الثلاث ، ولم يتم تنفيذ سوى القليل منها.	SUBJ
كما قاموا بتحسين جمع البيانات العرقية والإثنية ، بما في ذلك فئة جديدة من شأنها تمكين إحصاء أكثر دقة للأشخاص من أصل عربي.	OBJ
وأنهوا « حظر المسلمين » ومددوا وضع الحماية المؤقت إلى القادمين من بلدان مختلفة في العالم العربي ، مما يسمح للناس بالبقاء في الولايات المتحدة أثناء الصراعات المستعرة في بلدانهم الأصلية.	OBJ
ولكن بصرف النظر عن هذه الإنجازات القليلة ، فإن القصة التي يجب سردها هي ما لم تفعله إدارة بايدن.	SUBJ
خلال السنوات الأربع بأكملها من ولايته ، لم يلتق الرئيس ولا نائبه ( أو مستشار الأمن القومي ) بقادة المجتمع العربي الأميركي.	SUBJ
كانت هناك اجتماعات ناضلنا من أجلها وفزنا بها مع وزير الخارجية والمدعي العام ، ولكن لم يكن هناك أي لقاء مع كبار القادة في البيت الأبيض.	SUBJ
كان لهذا الإقصاء تأثير على الحكومة بأكملها.	SUBJ
وبينما افتتحت وثيقة حملة بايدن بالقول : « لقد تم استخدام التعصب ضد العرب في محاولات لاستبعاد وإسكات وتهميش مجتمع بأكمله.	SUBJ
بايدن يحتضن شراكة الأميركيين العرب.	SUBJ
» ، وجد البيت الأبيض في الواقع طريقة جديدة لاستبعادنا وإسكاتنا وتهميشنا.	SUBJ
• سارعت الإدارة إلى قبول إسرائيل في برنامج الإعفاء من التأشيرة الأميركية ، على الرغم من الأدلة الموثقة التي تثبت أن إسرائيل لم تف بشرط أساسي من متطلبات البرنامج - وهو ضمان المعاملة بالمثل للأميركيين العرب الساعين إلى الدخول إلى إسرائيل والخروج منها.	OBJ
لكن إدارة بايدن كانت تعلم أن هذه الممارسات مستمرة ومع ذلك فقد داست على حقوق مواطنيها ومتطلبات قوانينها الخاصة لمنح إسرائيل هذا الامتياز غير المستحق.	SUBJ
• ربما كان أكثر الأمور التي عرضت هذه الإدارة للسخط هو تعاملها مع الحرب على غزة.	SUBJ
على سبيل المثال : « يؤمن جو بايدن بقيمة كل فلسطيني وكل إسرائيلي.	SUBJ
وسيعمل على ضمان تمتع الفلسطينيين والإسرائيليين بمقاييس متساوية من الحرية والأمن والازدهار والديمقراطية ».	SUBJ
« يعارض بايدن الضم والاستيطان.	SUBJ
وسيعمل على معالجة الأزمة الإنسانية المستمرة في غزة.	SUBJ
أتمنى من كل قلبي أن نكون في الكويت في طريق الانفتاح والانطلاق نحو الإنجازات وتحقيق الآمال والأحلام.	SUBJ
التي لطالما راودتنا وفتحت المجال لمقارنة أنفسنا بغيرنا ، وطرح تساؤل بديهي لا يحتاج الى اي مراوغة ، ماذا ينقصنا ؟	SUBJ
ورشة عمل تدور رحاها في أرجاء الوطن.	SUBJ
لا يمكن أن ننكرها بأي حال من الأحوال ، مهما كنا معارضين ومهما كنا ناقمين ، ومهما كنا مصرين على الانتقاد بكل الأحوال وكل الظروف.	SUBJ
ورشة الطرق ، ورشة الزراعة ، ورشة المشاريع ، ورشة تنظيم الهوية الوطنية ، ورشة تطوير وتوسيع الخدمات الصحية ونسف النظام التعليمي.	OBJ
فهو أعمى البصيرة قبل العين.	SUBJ
إن لم نكن قادرين على الاختراع.	SUBJ
فلنكن مطورين لما وصل أو أنجزه الآخرون.	SUBJ
هناك جملة قرأتها وأعجبتني تقول : « إذا لم تستطع الابتكار أو الاختراع كاليابانيين.	SUBJ
شبابنا مشهود لهم بالإبداع في كل مجال ، بشرط ألا تقيدهم قوانين واجراءات نظرية لا يمكن تطبيقها ، وتشجيعهم على إطلاق العنان للأفكار وتسهيل التطبيق لهم وتحفيزهم على الإنجاز.	SUBJ
الحداثة والحضارة ليستا بارتفاع المباني والأدوار ، بل بارتفاع مستوى التوقعات والابتكار.	SUBJ
ماضينا جميل ويدعو إلى الفخر.	SUBJ
وبشدة أيضا عندما كنا أول من.	SUBJ
على أن ينسحب الجيش الإسرائيلى من معظم المناطق الخاضعة لسيطرته فى غزة.	SUBJ
وحسب الاتفاق ، فإن عملية إطلاق سراح أول دفعة من الأسرى الإسرائيليين ضمن المرحلة الأولى ستتم فى اليوم السابع من وقف إطلاق النار.	OBJ
أما المرحلة الثالثة والأخيرة ، فتخص الترتيبات طويلة الأمد وإدارة القطاع فى « اليوم التالى » ، كما تشمل خطط إعادة إعمار القطاع.	SUBJ
تبقى مشكلة الاتفاق فى أعقاب مرحلته الثانية ، أى عقب إفراج حماس عن كل الأسرى الإسرائيليين ، وهل ستحترم دولة الاحتلال وقف إطلاق النار أم ستعود إلى ارتكاب جرائم الإبادة الجماعية مرة أخرى فى غزة ، خاصة أنه لا توجد ضمانات أمريكية واضحة بمنع تكرارها.	OBJ
هذا عدا مستودعات الذخيرة والصواريخ ، فكيف يكون الانتصار ؟	SUBJ
"والدليل الأكبر على سقوط نظرية "" وحدة الساحات "" أن "" حزب الله "" وافق على اتفاق وقف إطلاق النار ، ولم يشترط للقبول أن يتم وقف النار في غزة ، فوافق فيما استمرت الحرب في غزة ، فأين هي وحدة الساحات ؟"	OBJ
ألم يحن الوقت بعد لجمع هذا السلاح ؟	SUBJ
ستظل الإدارة الأميركية الجديدة ، وشخص الرئيس ترامب في حاجة إلى حسم في التعامل مع إيران ، ليس وفق النهج الأوروبي الراهن ، وإنما وفق معادلة حقيقية عملية ، الأمر الذي قد يكون للشريك العربي دور في القبول أو الرفض لما يجري ، خاصة مع الانكسارات الإيرانية في الملفين السوري واللبناني ، ما يؤكد أن مساحات التعامل ستظل قائمة ومتاحة ، وأن اسرائيل التي تحظي بدعم أميركي كبير ولافت.	OBJ
ومن ثم ، فإن التحرك المتوقع للرئيس ترامب تجاه حل القضايا الراهنة أو الانتقاء من بينها كأولويات متعلقة بحجم التفوذ والحضور الأميركي في الشرق الأوسط سيكون وفق استراتيجية حقيقية ومدروسة ، والعمل على مساحات من التلاقي الرئيس ، خاصة أن أغلب القضايا المتعلقة بليبيا واليمن وسوريا وغزة وأمن الإقليم وجنوب البحر الأحمر ، وغيرها من الملفات تشتبك الولايات المتحدة في الكثير من تطوراتها.	OBJ
بعد أن تدفقت مياه كثيرة ودماء غزيرة في نهر الصراع.	SUBJ
زبدة الاتفاق المتحدث عنه ، أن لا « حماس » في غزة ، وأمن شخصي لمن يبقى من قياداتها ، وقوة محايدة لإدارة غزة ، مع بقاء قوة عسكرية إسرائيلية ، وإطلاق الرهائن من غزة ، وبعض الأسرى عند إسرائيل إلى خارج أرض فلسطين!	OBJ
لقد انطبق على القيادة الحماسية ما انطبق على الثوريين العرب ، وهو « تفويت الفرص ».	SUBJ
أهم درس نخرج به من كل ملفات السنة ونيف التي مرت بتاريخنا العربي المعاصر هو قدرة هائلة في تفويت الفرص ، وقد جاءت تلك القدرة من مخزون فكري هو تغليب الأدلجة على الواقع ، وفقر مدقع في الخيال السياسي ، وقراءة خاطئة لإمكانات العدو ، وبأي وسيلة يمكن مواجهته ؛ هو يعتمد على العلم ، والآخرون يغلبون العواطف المحملة بشعوذة سياسية ، ويفتقدون الحوار الداخلي الحر فيما بينهم في كيفية المواجهة أو طريق المفاوضة.	OBJ
في نهاية الأمر ونحن نقترب من الدخان الرمادي ، نجد أنه دخان ملوث يفتقد البصيرة وعدم القدرة على مقاربة الواقع الإقليمي والعالمي ، وثمة خسارة مؤكدة وتضحيات هائلة لم تنتج إلا الحسرة.	SUBJ
آخر الكلام : سوف يحصل الغزيون على غزة منقوصة الجغرافيا ، ومن دون سيطرة « حماس » ، والكثير من المقابر الجديدة ، ومع ذلك سنجد من يتحدث عن « الانتصار »!	SUBJ
يهدف هذا القرار ، بحسب تصريحات القيادة الإسرائيلية ، إلى حماية العسكريين من الملاحقات القانونية فى الخارج ، خاصة فى ظل الاتهامات المتكررة بارتكاب جرائم حرب.	OBJ
جاء هذا القرار فى أعقاب ارتفاع عدد القضايا التى رفعتها منظمات حقوقية دولية ضد جنود إسرائيليين فى المحاكم العالمية.	SUBJ
وقد أكدت رئاسة الأركان الإسرائيلية أن القرار يشمل جميع العسكريين ، باستثناء بعض وحدات النخبة ، وسيتم فرض قيود على نشر صور الجنود أو أسمائهم ، مع الاكتفاء باستخدام الأحرف الأولى فى حال إجراء مقابلات إعلامية.	OBJ
إن تصاعد قلق كهذا فى الأوساط العسكرية الإسرائيلية يأتى بعد تقارير عن تحركات قانونية فى عدة دول.	SUBJ
فقد تمكنت إحدى المحاكم فى البرازيل من فتح تحقيق ضد جندى إسرائيلى كان يزور البلاد ، بعد اتهامه بالتورط فى انتهاكات موثقة بالفيديو.	SUBJ
واستدعى هذا الحادث تدخل وزارة الخارجية الإسرائيلية لإخراجه من البرازيل بشكل عاجل.	SUBJ
ومن جهته ، أشار وزير القضاء الإسرائيلى الأسبق شمعون شتريت إلى أن التعليمات الجديدة قد تسهم فى الحد من انتهاك التعليمات العسكرية المتعلقة باستخدام الصور ، مما يقلل من احتمالية الملاحقات.	OBJ
أيا كانت الإجابة ، فما هو مؤكد أن جرائم الاحتلال لن تسقط بإخفاء الهوية!	SUBJ
الأخبار فى شهر يناير أقل عنفا وحزنا مما كانت عليه قبل أسابيع ؛ وهناك بعض من الزحف البطيء نحو عالم أفضل.	SUBJ
اختيار « جوزيف عون » رئيسا للبنان كسر حلقة جهنمية تمنع استكمال البناء السياسى فى لبنان الذى يقوم على تمثيل متكافئ للأركان الأساسية للنظام اللبنانى.	OBJ
ما حدث من كسر لنفوذ حزب الله الذى مثل الثلث المعطل - هكذا كان الوصف والموصوف - للنظام السياسى فى الدولة الشقيقة ؛ جعل استئناف الحياة ممكنة فى دولة قامت على الحداثة فى قلب العالم المعاصر والأعراف التقليدية فى حزمة مثيرة.	OBJ
أصبح وقف إطلاق النار على الجبهة اللبنانية - الإسرائيلية نافذا ، وانخفض تبادل القصف الصاروخى ، وباتت إسرائيل تفكر فى عودة النازحين إلى ديارهم مرة أخرى.	SUBJ
فى المقابل فإن الضغط يزداد على إسرائيل لكى ترحل عن الجنوب ؛ ورئيس وزراء لبنان نجيب ميقاتى يعلن أنه لن يكون هناك تسليح فى جنوب الدولة إلا من خلال جيشها.	OBJ
باختصار فإن لبنان يستعيد قيمته كدولة بلا ثلث معطل ولا فصل ما بين الدولة واستخدام السلاح الذى تراجع إلى جنوب نهر الليطانى.	SUBJ
أصبح ممكنا النظر بجدية إلى وقف إطلاق النار على جبهة غزة الفلسطينية الحمساوية وإسرائيل.	SUBJ
الزخم بات كبيرا مع تدخل ترامب الذى كان حازما مع حماس بإدخال « جهنم » فى الصورة ، ومع نيتانياهو أنه سوف يتولى السلطة لكى يحل المعضلات وليس لوقف إطلاق النار.	SUBJ
جبهتان أخريان حدث فيهما وقف لإطلاق النار دون حديث ؛ الجبهة السورية انفجرت دون قتال ؛ وتولت إسرائيل تدمير الجيش السورى دونما حرب ؛ والجبهة العراقية قررت أن تصمت طالما أن المدافع صمتت فى لبنان وسوريا ؛ وغزة تحاول الوصول إلى الحالة الصامتة.	SUBJ
جبهة اليمن ظلت على علاتها ؛ والحوثيون ما زالوا يناوئون ، ولكن أعداد صواريخهم تراجعت بعد ضربة جوية مشتركة بين إسرائيل والولايات المتحدة وبريطانيا جلبت تدميرا هائلا بطول الساحل الغربى لليمن.	OBJ
إيران لا تحتاج لإعلان المراجعة لموقفها المناسب لما انتهت إليه حالة الحرب!	SUBJ
قبل فترة طويلة من الحرائق التي اجتاحت لوس أنجلوس ودمرت ما لا يقل عن 12 ألف منزل حتى الآن ، واجهت المدينة أسوأ أزمة مشردين في البلاد.	OBJ
فعلى مدى العقد الماضي ، ارتفعت أسعار العقارات في كاليفورنيا بشكل كبير.	SUBJ
ومع ارتفاع الأسعار ، استثمر العديد من سكان لوس أنجلوس المنتمين إلى الطبقة المتوسطة مدخراتهم في منازلهم.	SUBJ
وسيكون من مهام هذا الأخير إظهار القيادة في وقت تشهد فيه البلاد كارثة وطنية.	SUBJ
وبالتالي ، فإن ما يحدث في كاليفورنيا له تأثير عالمي.	SUBJ
وعلى سبيل المقارنة ، فإن مدينة نيويورك استغرقت 10 أشهر من أجل إزالة الأنقاض الناجمة عن الهجمات الإرهابية على البرجين التوأمين في 11 سبتمبر 2001.	OBJ
وبينما تتواصل عملية التنظيف ، ستحتاج آلاف العائلات إلى إيجاد مساكن مؤقتة ، بينما تنتظر لمعرفة نوع التعويضات ، التي يمكن أن تحصل عليها من شركات التأمين وبرامج الإغاثة الحكومية والفيدرالية.	OBJ
ولا شك أن هذه العملية ستكون مؤلمة وستخلق للجميع تحديات سياسية لا نهاية لها.	SUBJ
كل هذا بات يحدث بوتيرة متزايدة في الولايات الأكثر عرضة للأعاصير والفيضانات وحرائق الغابات ، وتشمل كاليفورنيا وفلوريدا وتكساس.	OBJ
وما يميز وطننا الحبيب ذلك النسيج الاجتماعي الغني بالألوان والتنوع الثقافي والموروث الحضاري.	OBJ
إن التمازج والاختلاط هو جزء أساسي من النسيج الاجتماعي وتشابكه وتداخله وجمال المكون وترابطه وتفاعله ومرونته.	OBJ
بالإضافة لذلك دعا الرئيسان شهاب وعون للوحدة الوطنية والشعور بالانتماء من خلال تنشئة سياسية والتركيز على الشباب.	SUBJ
فكان لا بد لعون أن يرتكز على تطوير وعي الشباب وتوجيه الموارد لكسب دعم شريحة كبيرة من المجتمع وبناء جهاز حكومي يعمل بكفاءة.	SUBJ
ولكن لماذا يتقدم على شهاب بالتنفيذ ؟	SUBJ
"سؤال أجابته "" دروس الماضي "" حيث استفاد عون من تجارب أسلافه لتجنب أخطاء الماضي ، بالإضافة لدعم دولي قوي بأهداف إصلاحية وخطط تنموية."	SUBJ
كما لا بد من التأكيد على دور البنى التحتية الحديثة والتكنولوجيا في تحسين فعالية تنفيذ السياسات ، عكس الحال في زمان الرئيس شهاب.	OBJ
لقد جاء خطاب فؤاد شهاب كما خطاب عون بعد فترة من الاضطرابات ، وللرئيسين تأثير كبير في تعزيز الاستقرار في لبنان.	SUBJ
الآن ، تتساءلون ما « الجنوب العالمي » ؟	SUBJ
في الواقع ، مسألة تقسيم العالم على أسس جغرافية زائفة لها تاريخ طويل.	SUBJ
من جهته ، رأى ماركس ، الذي تظاهر بأنه اكتشف قوانين التاريخ البشري ، أنه من الضروري الاعتراف بأن تحليله لا ينطبق على « المجتمعات الآسيوية » ، التي كان يقصد بها كل العالم خارج أوروبا وأميركا الشمالية.	OBJ
وتكشف الأرقام عن أن قيمة التجارة بين إيران وروسيا عام 2023 بلغت نحو 1.	SUBJ
9 مليار دولار ؛ ما يمثل قرابة واحد في المائة من مجمل التجارة الخارجية لإيران.	OBJ
في سياق متصل ، بلغت تجارة إيران مع طاجيكستان أقل من 50 مليون دولار ، ما يعادل ثمن شقة في مانهاتن.	OBJ
وفي حين يعيش قرابة ثلاثة ملايين إيراني داخل الولايات المتحدة ، كان جزء من « الشمال العالمي » في روسيا يستضيف بضع مئات فقط من المسؤولين والطلاب القادمين من إيران.	OBJ
وفي كتابيه « الطريق الجنوبي » و « لماذا تنتصر الرأسمالية في الغرب ، وتفشل في كل مكان آخر ؟	SUBJ
ومنذ نهاية « الحرب الباردة » ، ظهر مفهوم « الجنوب العالمي » ، في نسخ مختصرة.	SUBJ
أما « التوجه نحو الجنوب » ، فهو تعبير في اللغة الإنجليزية يجري استخدامه عندما تسير الأمور بشكل سيئ أو تنتهي إلى الفشل.	SUBJ
أما آسيا ، فتقدم صورة مختلطة.	SUBJ
وداخل إيران نفسها ، بدأت حتى الشخصيات داخل النظام « الجنوبي » تدرك أن نظامهم ربما « يتجه نحو الجنوب ».	SUBJ
وقبل أن يسافر إلى طاجيكستان ، أدلى الرئيس بزشكيان بهذا الاعتراف المذهل : « إن الوضع الذي نعيشه لا يليق بالأمة الإيرانية ».	SUBJ
فقد انقلب المشهد عليكم وأصبحتم الآن في موقع الدفاع عن السلطة من جهة ، ومن جهة أخرى في موقع الاتهام من معارضة جديدة.	SUBJ
أنهى صديقي حديثه وتوصياته وتركني في ارتباك وحيرة.	SUBJ
فيما تفرض علينا الموالاة أن يكون الولاء للدولة ، لمصلحتها العامة ، وإلزامها بالعدالة والنزاهة والأمن لكل مواطنيها ، موالين كانوا أو معارضين.	SUBJ
لم نعد حذرين عند دخولنا مطار بيروت من عرقلة أمنية أو مضايقة.	SUBJ
لم تعد أجهزة الدولة في موقع الخصم ، حتى المعادي.	SUBJ
رفاق النضال الكبار ، المعلمون الأوائل ، عاشوا لعقود وهم ليسوا فقط معارضين ، بل محاصرون ، ومطاردون في لبنان ، أو منفيون في الخارج ، أو شهداء.	SUBJ
وعليه ، في لغة تعريف الموالاة ، ينحصر معناها في المحبة والدعم والنصرة ، أي الوقوف إلى جانب المشروع ، وليس الولاء لحزب أو شخص.	OBJ
فما أصعب الموالاة في قاموسنا!	SUBJ
بعد النشوة الكبرى التى اجتاحت العالم العربى فور معرفته بهجمات حماس على إسرائيل فى ٧ أكتوبر ٢٠٢٣ ، وبدء العدوان الوحشى على غزة وشعبها ، وقفت الغالبية الكبرى مع حماس ودعمتها بلا حدود.	SUBJ
صحيح أن الدماء مازالت ساخنة ، والدمار هو العنوان الرئيس فى غزة ، إلا أنه من المهم جعل مراجعة ما جرى أولوية ، بل فرض عين.	SUBJ
الحرب كرست استبعاد القضية الفلسطينية بعناصرها الأساسية ، وفى مقدمتها الدولة المستقلة ، وجعلتها أقرب إلى قضية إنسانية تتطلب إنقاذ الفلسطينيين من القتل والتدمير والتشريد بل الترحيل.	OBJ
ساهم فى ذلك الانقسام الفلسطينى الذى استغلته إسرائيل فى ارتكاب مزيد من الجرائم وتجاهل رد الفعل العالمى وحتى القضاء الدولى.	SUBJ
الحرب العدوانية - التى كان من المفترض أن تؤدى لتقريب بل توحيد الرؤية والتحرك بين الفلسطينيين - فاقمت الانقسامات والاتهامات المتبادلة بين حماس والسلطة ، فى وقت استهدفت إسرائيل الجميع ، سواء بالقتل والتدمير والإبادة فى غزة ، أو بالاقتحامات وسرقة الأراضى والممتلكات فى الضفة.	OBJ
الإحصاءات عما خلفه العدوان مرعبة.	SUBJ
١١٠ آلاف جريح ، ربعهم إصابات دائمة.	SUBJ
كان هناك ٥٦٤ مدرسة قبل الحرب ، ٥٣٤ منها جرى تدميرها أو جعلها غير صالحة للتعليم.	SUBJ
٩ مليون شخص ، أى ٩٠ ٪ من أبناء القطاع ، نزحوا مرات عديدة.	OBJ
مئات الآلاف يعيشون فى الخيام والملاجئ التى لم يتورع الاحتلال عن قصفها.	SUBJ
الحرب خلفت ٤٠ مليون طن من حطام المبانى والمنازل.	SUBJ
إزالة الألغام ستستغرق ١٠ سنوات.	SUBJ
هل فكر الذين خططوا ونفذوا الهجمات فى أن تلك ستكون النتيجة ؟	SUBJ
وهل كان من الممكن التوقف عن بعض ممارسات جرت خلال الهجمات ، استغلتها الدعاية الصهيونية وبررت بها الوحشية التى تعاملت بها مع الفلسطينيين ؟	SUBJ
ليس هذا وقت إصدار الأحكام.	SUBJ
المرحلة المقبلة مصيرية للقضية الفلسطينية.	SUBJ
أساليب الماضى والنكوص على اتفاقات توحيد الصف والاستفراد بالقرار وعدم إشراك المواطنين فى القرار ، بداية من الانتخابات وحتى الموافقة على الاتفاقات ، لم تعد تصلح.	OBJ
كان يمكن تجاهل ما قاله الضيف ، ولكن العدد غير العادي الذي أيد كلامه ، تطلب كتابة هذا المقال ، ولا يعني ذلك أن ما سأقوله صحيح ، في جميع الأحوال.	SUBJ
كما أن هناك الغناء العدني ، الذي تأثر بفنون الموسيقى الهندية والأفريقية ، وثالثها الغناء الحضرمي ، الذي تميز بهدوء الصوت واللحن العذب.	OBJ
ومع بداية القرن العشرين ، تأثرت الموسيقى اليمنية بالفنون المصرية ، مع إدخال آلات موسيقية جديدة عليها ، ومن اليمن جاء عدد من أشهر مطربي الجزيرة.	SUBJ
ولكون الكويت دولة ساحلية ، فقد اشتهرت بالأغاني البحرية التي ارتبطت بحياة الغوص على اللؤلؤ والصيد والتجارة البحرية.	SUBJ
ويعد فن الصوت فيها من أبرز الفنون الغنائية التقليدية ، وهو نمط يجمع بين الشعر الغنائي واللحن الحماسي.	OBJ
كما اشتهرت الكويت بالأغاني الشعبية للأعراس والأعياد ، ومن أشهر ألوانها فن الخماري والسامري.	OBJ
وفي منتصف القرن العشرين ، ظهر فيها عدد من الفنانين الذين أسهموا في تحديث الأغنية الكويتية ، مثل عبدالله الفضالة ، وشادي الخليج ، وعوض الدوخي.	OBJ
كما يعود تاريخ المسرح في الكويت إلى العقد الثاني من القرن العشرين ، حين بدأ الكويتيون بإقامة عروض مسرحية بسيطة تعتمد على القصص الشعبية ، حيث عرضت عام 1924 أول مسرحية مدرسية بعنوان « إسلام عمر ».	OBJ
وكان للفنان المصري زكي طليمات دور كبير في تأسيس المسرح الكويتي الحديث.	SUBJ
كما سبقت الكويت غيرها بكثير في إبراز دور المرأة في الفن ، من خلال مريم الصالح ، والغضبان ، وسعاد عبدالله وحياة الفهد ، ولا ننسى عمالقة المسرح من أمثال عبدالحسين عبدالرضا وخالد النفيسي ، وكبار العمالقة الآخرين.	OBJ
عرف الخليج أول دار سينما في الكويت عام 1955 ، وكنت من أوائل من دخلها ، مع والدي ، في السينما الشرقية ، التي كانت تقع خلف برج أحمد وديوان الملا ، المطلين على مياه الخليج.	OBJ
ومع ذلك ، فإن نجاح هذا القرار يتطلب توفير الموارد الكافية والبنية التحتية المناسبة لضمان تنفيذه بالشكل الأمثل.	SUBJ
على سبيل المثال ، يمكن إطلاق برامج شراكة لتوفير خدمات إضافية مثل الدعم النفسي والاجتماعي لكبار السن وأسرهم.	SUBJ
في تجارب دولية مشابهة ، نجحت بعض الدول في إنشاء برامج متكاملة لرعاية كبار السن تجمع بين الرعاية الصحية والدعم النفسي والاجتماعي ، مثل برامج « الرعاية المجتمعية » التي تشرك الأسر والشباب في تقديم الدعم.	OBJ
ويمكن للمملكة الاستفادة من هذه النماذج لتطوير آليات جديدة تدعم القرار وتعزز من تأثيره.	SUBJ
من المهم أن يكون للمجتمع دور فاعل في تعزيز هذه المبادرة.	SUBJ
على الأفراد والمؤسسات تبني مبادرات تطوعية تساهم في تحسين جودة حياة كبار السن ، مثل تنظيم زيارات للمسنين أو إطلاق برامج تدريبية للشباب عن كيفية تقديم الرعاية لهم.	SUBJ
عندما يشاهد الشباب كيف يتم تكريم هذه الفئة ، فإنهم يتعلمون أن هذه القيم هي أساس المجتمعات المتحضرة.	SUBJ
إنه تأكيد على الواجب الوطني تجاه فئة غالية وركن أصيل من مجتمعنا ، فئة حملت على عاتقها بناء هذا الوطن وصياغة هويته.	SUBJ
حين تضع القيادة كبار السن في مقدمة الأولويات ، فإنها ترسم صورة مضيئة لمجتمع لا ينسى جذوره ، ولا يغفل عن رد الجميل لمن كان لهم الدور الأكبر في ماضيه وحاضره.	SUBJ
